abschaffen_s378_f1	Hinzu kommt , daß in der letzten Zeit eine Reihe der staatlichen Subventionen für die Grundnahrungsmittel 	abgeschafft 	worden sind , dank derer sich die arme Bevölkerung über Wasser halten konnte . 
abschaffen_s684_f1	Die Wehrpflicht wird ab 1994 	abgeschafft 	. 
abschaffen_s711_f1	Der Antrag von Pirelli , beim Reifenhersteller Continental die Beschränkung des Stimmrechts auf fünf Prozent 	abzuschaffen 	, ist auf der Hauptversammlung gescheitert . 
abschaffen_s1030_f1	`` Mankeywordtag sollte alle Zuschüsse zur Sparförderung einschränken oder 	abschaffen 	. '' 
abschaffen_s2628_f1	die Folter werde 	abgeschafft 	; 
abschaffen_s2724_f1	Zwar brüstet sich die Regierung in Ankara nun mit einer Reform des Strafprozeßrechts , diekeywordtag helfen soll , Polizeiwillkür und Folter 	abzuschaffen 	. 
abschaffen_s2929_f1	Die belgische Mitte-Links-Regierung hat beschlossen , die allgemeine Militärdienstpflicht bis Ende 1993 	abzuschaffen 	und im Rahmen einer weitgehenden Reorganisation mit dem Ausverkauf militärischen Materials zu beginnen . 
abschaffen_s2947_f1	Belgienkeywordtag würde seinen internationalen Verpflichtungen nicht mehr nachkommen können , falls die Wehrpflicht 	abgeschafft 	, der Verteidigungsetat eingefroren und das militärische Material verringert werden sollte . 
abschaffen_s3660_f1	Als zweite der früheren Sowjetrepubliken wird Lettlandkeywordtag nach Estland eine eigene Währung einführen und den Rubel 	abschaffen 	. 
abschaffen_s5841_f1	Er ist Chef der Exekutive - das Amt des Regierungschefs wird 	abgeschafft 	- , kann aber das Parlament nicht auflösen . 
abschaffen_s5849_f1	Nach dem gewaltsamen Sturz Gamsachurdias Anfang 1992 war das Präsidentenamt zunächst 	abgeschafft 	worden . 
abschaffen_s6006_f1	Er warnte davor , den Sonntag wegen wirtschaftlicher Vorteile langsam 	abzuschaffen 	. 
abschaffen_s8121_f1	Das Präsidentenamt war mit der am Sonntag in Kraft getretenen neuen Verfassung wieder eingeführt worden , nachdem eskeywordtag Anfang 1992 nach dem Sturz des ersten Präsidenten Swiad Gamsachurdia 	abgeschafft 	worden war . 
abschaffen_s10066_f1	Wenn Kohls Kämmerer weiter in gewohnter Manier `` Punktlandungen '' übt , das `` Auf ohne Schwung '' verdrängt , Städten und Gemeinden die Einnahmequellen verstopft , ganze Unternehmenssteuern 	abschaffen 	will , großzügig über das `` Kavaliersdelikt '' der Steuerhinterziehungen hinwegsieht und damit auf dreistellige Milliardeneinnahmen verzichtet , brauchen weder Bonn noch die Hauptstädte in Europa die Debatte über die künftigen Mitgliedsländer der Währungsunion zu fürchten . 
abschaffen_s12377_f1	Nach Einschätzung des Gerichts seien die Bestrebungen der drei Rechtsradikalen unvermindert darauf ausgerichtet , die Bundesrepublik 	abzuschaffen 	und - wie in ihren Publikationen angekündigt - einen sogenannten `` deutschen Volksstaat '' zu errichten . 
abschaffen_s13034_f1	Ganz gleich ob siekeywordtag am Ladenschlußgesetz hängen , eskeywordtag ändern oder 	abschaffen 	wollen : 
abschaffen_s13080_f1	Ganz gleich ob siekeywordtag am Ladenschlußgesetz hängen , eskeywordtag ändern oder 	abschaffen 	wollen : 
abschaffen_s13799_f1	So steht es schon im Reformkonzept der schleswig-holsteinischen Landesregierung unter Heide Simonis ( SPD ) , diekeywordtag keineswegs alle Beamten 	abschaffen 	will , wie man ihr vorwirft , aber eine Änderung des Grundgesetzes für unverzichtbar hält . 
abschaffen_s15008_f1	Ferner sollen die Unternehmenssteuern weiter gesenkt sowie Beschlüsse vorgelegt werden , um die Vermögens- und Gewerbekapitalsteuer 	abzuschaffen 	. 
abschaffen_s15978_f1	Der Verband bekenne sich zum sozialen Wohnungsbau und wolle ihnkeywordtag keinesfalls 	abschaffen 	, betont Steinert . 
abschaffen_s19582_f1	Werksferienkeywordtag sollen 	abgeschafft 	werden 
abschaffen_s19592_f1	Zwar solle die Auszeit nicht generell 	abgeschafft 	werden , doch wolle das Management mehr Beweglichkeit . 
abschaffen_s24453_f1	Dagegen erwartet das Europäische Währungsinstitut , daß das neue Eurogeld spätestens am 1. Juli 2002 einziges gesetzliches Zahlungsmittel in den Teilnehmerländern der dritten Stufe der Europäischen Währungsunion ( EWU ) ist und die D-Mark 	abgeschafft 	sein wird . 
abschaffen_s24497_f1	Regierungkeywordtag will die Todesstrafe 	abschaffen 	
abschaffen_s24499_f1	Belgienkeywordtag will die Todesstrafe 	abschaffen 	. 
abschaffen_s29652_f1	Anfang 1995 wurde die Abgabe für Touristen 	abgeschafft 	. 
abschaffen_s30032_f1	Schlimmer ist , daß die Garantie für die ungarische Minderheit auf Verwendung der Muttersprache bei Behörden 	abgeschafft 	wird und in dieser Frage bestenfalls ein Vakuum bleibt . 
abschaffen_s30581_f1	Die Todesstrafe könnte in Deutschland selbst mit einer Grundgesetzänderung nicht mehr eingeführt werden , weil die Änderung des Artikels 102 ( `` Die Todesstrafe ist 	abgeschafft 	'' ) ein Verstoß gegen die Menschenwürde und gegen das Grundrecht auf Leben wäre . 
abschaffen_s31111_f1	Mit der Aktion am Donnerstag wollte die Vereinigung der Wehrpflichtigen erreichen , daß die Dienstpflicht nicht wie geplant erst 1997 	abgeschafft 	wird , sondern sofort . 
abschaffen_s39843_f1	Einen Einbruch der Investitionen im Mietwohnungsbau fürchtet der Bundesverband Freier Wohnungsunternehmer , wenn die degressive Abschreibung 	abgeschafft 	und durch einen linearen Satz von zwei Prozent ersetzt werden sollte . 
