appellieren_s1079_f1	Der russische Regierungschef Jegor Gaidar 	appellierte 	nach Angaben der Nachrichtenagentur Interfax auf der Veranstaltung an alle demokratischen Kräfte in Rußland , sich der Gefahr des Totalitarismus zu widersetzen . 
appellieren_s3243_f1	Die Staats- und Regierungschefs der auf dem Münchner Gipfel versammelten sieben Industrienationen wollen gemeinsam an Unternehmen und Wirtschaftsverbände ihrer Länder 	appellieren 	, zum Aufbau einer sozialen Marktwirtschaft in den neuen unabhängigen Staaten der ehemaligen Sowjetunion beizutragen . 
appellieren_s5187_f1	Ichkeywordtag 	appelliere 	daher an Siemens und Daimler-Benz , hierzulande mit dieser Technologie Exportchancen zu wahren und Arbeitsplätze zu sichern . 
appellieren_s7453_f2	Werkeywordtag an unserekeywordtag Verantwortung für die bequemere große Koalition 	appelliert 	, verführt uns zur Unverantwortlichkeit gegenüber der Grundlage unserer Demokratie . 
appellieren_s8376_f1	Zwar 	appellierten 	alle , von Präsident Ezer Weizman bis zu Likudchef Bibi Netanyahu , an die Bevölkerung , nun zusammenzustehen . 
appellieren_s8886_f1	Der Präsident des Bundeskriminalamtes ( BKA ) , Hans Ludwig Zachert , hat an die Wirtschaft 	appelliert 	, die Kriminalität in ihren eigenen Reihen stärker zu bekämpfen . 
appellieren_s10370_f1	`` Wir müssen gemeinsam Verantwortung für Europa übernehmen '' , 	appellierte 	Waigelkeywordtag an die SPD und die von ihr beherrschte Länderkammer . 
appellieren_s10631_f1	Stahmerkeywordtag 	appellierte 	noch einmal an die Delegierten , den Auftrag für Sondierungsgespräche mit der CDU zu erteilen . 
appellieren_s10634_f1	Auch der stellvertretende SPD-Bundesvorsitzende Wolfgang Thierse 	appellierte 	an die Delegierten , die Möglichkeit der großen Koalition offenzuhalten . 
appellieren_s10963_f1	Der Verteidigungsminister der Elfenbeinküste , Leon Konan Koffi , 	appellierte 	angesichts der Ergebnisse der UN-Studie an die Konferenzteilnehmer , konkrete Hilfsprogramme für die betroffenen Kinder zu beschließen und umzusetzen . 
appellieren_s11659_f1	Wirkeywordtag werden im kommenden Jahr versuchen wieder neuen Schwung zu finden und 	appellieren 	an alle Studierenden , sich mehr mit Hochschulpolitik auseinanderzusetzen und vor allem sich aktiv zu engagieren . 
appellieren_s12585_f1	Debattierten , diffamierten , 	appellierten 	, stießen in Worte verpackte Angstschreie aus , haufenweise . 
appellieren_s12811_f1	Der Verteidigungsminister der Elfenbeinküste , Leon Konan Koffi , 	appellierte 	angesichts der UN-Studie an die Konferenzteilnehmer , konkrete Hilfsprogramme für die betroffenen Kinder zu beschließen und umzusetzen . 
appellieren_s13358_f1	Mehrere Regierungschefs von Commonwealth-Ländern haben am Donnerstag an die Militärregierung Nigerias 	appelliert 	, die Todesurteile gegen Bürgerrechtler aufzuheben . 
appellieren_s17495_f1	Wendorffkeywordtag 	appellierte 	deshalb an alle Pauschalurlauber , bei der Bezahlung eines Reisepakets nachdrücklich auf die Aushändigung des sogenannten Sicherungsscheins zu bestehen . 
appellieren_s18901_f1	Rothkeywordtag 	appellierte 	an Bonn , die kommunale Selbstverwaltung nicht weiter auszuhöhlen : 
appellieren_s19960_f1	Wirkeywordtag 	appellieren 	an die Sozialpartner sowie an die öffentlichen Arbeitgeber , Maßnahmen zur Förderung der Teilzeitarbeit , der Jahres- und Lebensarbeitszeit , Unterbrechungsmöglichkeiten der beruflichen Tätigkeiten , beispielsweise durch ein Sabbatjahr und bezahlte Freistellungen zur Förderung der beruflichen Qualifizierung , mit weiteren Formen der Arbeitszeitverkürzung zu kombinieren . 
appellieren_s20379_f1	Sowohl Cimi als auch die GfbV 	appellierten 	an die `` Freunde der indigenen Völker Brasiliens '' , sich mit Protestschreiben an den brasilianischen Präsidenten und Justizminister Nelson Jobim zu wenden . 
appellieren_s21212_f1	Im Wirtschaftsleitantrag des saarländischen Ministerpräsidenten Oskar Lafontaine 	appelliere 	die SPD aber nur noch an die Wirtschaft , wie es die Regierung seit Jahren tue . 
appellieren_s23007_f1	Die Guerillaorganisation URNG hatte zum ersten Mal während des 35jährigen Bürgerkrieges einen Waffenstillstand ausgerufen und an die 3,7 Millionen Wahlberechtigten 	appelliert 	, sich an den Wahlen zu beteiligen . 
appellieren_s23712_f1	Oppositionkeywordtag bekräftigt Boykottaufruf und 	appelliert 	an EU 
appellieren_s23715_f1	Auf einer Pressekonferenz in Bonn prangerten siekeywordtag am Dienstag den `` Terror '' der algerischen Führung an und 	appellierten 	an die Europäische Union ( EU ) , ihr `` Schweigen '' zu Menschenrechtsverstößen zu beenden . 
appellieren_s24693_f1	Aus unserer reichen und bitteren Erfahrung 	appellieren 	wirkeywordtag an unsere arabischen Kollegen , den palästinensischen `` Friedensritter '' nicht im Stich zu lassen . 
appellieren_s24726_f1	Ichkeywordtag habe immer wieder an die israelischen Friedensbefürworter 	appelliert 	, nicht zu zögern , die bittere Pille vor ihrem Volk zu schlucken , die ich und andere vor unserem Volk geschluckt haben : Nämlich die historische Wahrheit zu sagen , die alte wie die neue . 
appellieren_s26989_f1	Zugleich 	appellierte 	erkeywordtag an die Delegierten , jetzt eine Integrationsleistung zu vollbringen . 
appellieren_s28338_f1	Der FDP-Ehrenvorsitzende hat an die Mitglieder seiner Partei 	appelliert 	, den Großen Lauschangriff in der bis zum 11. Dezember laufenden Mitglieder-Befragung abzulehnen . 
appellieren_s29525_f2	Erkeywordtag will einen Teil der jährlich fast zwei Millionen Wander- und Ski-Touristen auf dem 1493 Meter hohen Feldberg sinnvoll lenken und an derenkeywordtag Einsicht 	appellieren 	. 
appellieren_s29747_f1	IG-Metall-Chef Klaus Zwickel hat in Mannheim überaus deutlich an diese Partei , die auch die seine ist , als Verbündete 	appelliert 	. 
appellieren_s33378_f1	Siekeywordtag will dabei an die Bonner Politiker 	appellieren 	, Druck auf die Regierung ihres Heimatlandes auszuüben . 
appellieren_s34350_f1	Der Präsident des Volksbundes , Hans-Otto Weber , hatte an die Deutschen 	appelliert 	, der Opfer von Krieg und Gewaltherrschaft zu gedenken und zu verhindern , daß gleiches wieder geschehe . 
appellieren_s36306_f1	Bei einem Vortrag am Sonntag abend in der DG Bank in Frankfurt 	appellierte 	Weltbank-Präsident James Wolfensohn an die Bundesrepublik , ihren Verpflichtungen als drittgrößter Geber nachzukommen . 
appellieren_s36581_f1	Die südostasiatischen Asean-Staaten haben an die führenden Wirtschaftsmächte der Welt 	appelliert 	, ihnen bei der Überwindung ihrer Finanz- und Währungskrise zu helfen . 
