Arbeitgeber_s90_f0	Dabei geht es vor allem um die Milliardenverluste produzierende verstaatlichte Industrie , diekeywordtag zugleich der größtekeywordtag 	Arbeitgeber 	istkeywordtag . 
Arbeitgeber_s1031_f0	Blessing zufolge sollte eine paritätisch besetzte Kommission aus Arbeitgebernkeywordtag und Arbeitnehmern die Krankmeldungen in den Betrieben untersuchen , um die Fehlzeiten zu senken . 
Arbeitgeber_s1040_f0	Rappe sprach sich dafür aus , daß nicht nur Arbeitgeberkeywordtag und Arbeitnehmer , sondern auch Selbständige und Beamte die Pflegeversicherung mitfinanzieren sollten . 
Arbeitgeber_s1365_f0	Der Parlamentarische Staatssekretär im Bundesarbeitsministerium , Horst Günther ( CDU ) , hat ein Urteil des Europäischen Gerichtshofs ( EuGH ) scharf kritisiert , das Arbeitgeberkeywordtag zur Lohnfortzahlung auch bei berechtigten Zweifeln an der Arbeitsunfähigkeitsbescheinigung verpflichtet . 
Arbeitgeber_s1368_f0	`` Dieses Urteil , das den Arbeitgeberkeywordtag zur Lohnfortzahlung in jedem Fall verpflichtet , ist weltfremd , praxisfern und kann dem Mißbrauch Tür und Tor öffnen '' , monierte Günther . 
Arbeitgeber_s1769_f0	Und zur Vollständigkeit der verkehrten Welt gehört auch , daß die Arbeitgeberkeywordtag keinen Grund sahen , sich negativ zu den Kurzstreiks zu äußern und sich mit der Bonner Regierung gemein zu machen . 
Arbeitgeber_s1927_f0	Ein Abweichen von den zwischen Gewerkschaften und Arbeitgebernkeywordtag ausgehandelten Tarifen soll aber nur mit Zustimmung der betrieblichen Interessenvertreter der Belegschaft möglich sein . 
Arbeitgeber_s3810_f0	Die Arbeitgeberkeywordtag hätten sich verhandlungsbereit gezeigt , sagte ein Sprecher der Gewerkschaft Nahrung-Genuß-Gaststätten ( NGG ) . 
Arbeitgeber_s3812_f0	Die Beschäftigten kritisierten , daß die Arbeitgeberkeywordtag sich bisher geweigert hätten , einen Tarifvertrag für das gesamte Bundesland abzuschließen . 
Arbeitgeber_s3986_f0	Vertreter der Regierung sowie der Fahrer und ihrerkeywordtag Arbeitgeberkeywordtag hatten in der Nacht einen Kompromiß ausgehandelt , der die Folgen des Punktesystems für die Berufsfahrer mildern soll . 
Arbeitgeber_s3991_f0	Sie sieht unter anderem vor , daß ein Lkw-Fahrer bei vorübergehendem Entzug des Führerscheins von seinemkeywordtag Arbeitgeberkeywordtag anderweitig beschäftigt wird . 
Arbeitgeber_s3992_f0	Der Arbeitgeberkeywordtag muß auch die Schulungskurse bezahlen , mit denen der Fahrer wieder einen Punktebonus erwerben kann . 
Arbeitgeber_s4041_f0	Im Gegenzug verlangt die Gewerkschaft , daß die Arbeitgeberkeywordtag drei Jahre hintereinander je 100 000 zusätzliche Stellen schaffen und 10 000 Langzeitarbeitslose einstellen . 
Arbeitgeber_s4045_f0	Die Arbeitgeberkeywordtag könnten allerdings durch ihre Verbände keine Arbeitsplatzzusagen oder Kündigungsschutzversprechen abgeben , schränkte Stihl ein . 
Arbeitgeber_s5238_f0	Dieses Bündnis verpflichtet - die Bundesregierung , - die Arbeitgeberkeywordtag - und auch uns zur Einhaltung . 
Arbeitgeber_s5267_f0	Die Einplanung dieser vom Arbeitnehmer verfügbaren Zeitanteile muß der Arbeitgeberkeywordtag genauso organisieren wie Auftragsschwankungen . 
Arbeitgeber_s5270_f0	Ich höre schon den Aufschrei der Arbeitgeberkeywordtag . 
Arbeitgeber_s5292_f0	Wir müssen zur Kenntnis nehmen , daß die Arbeitgeberkeywordtag - besser gesagt die Metallarbeitgeberverbände in den Regionen - unwillig und unfähig sind , im Rahmen von Verhandlungen nach neuen Lösungen zu suchen . 
Arbeitgeber_s5598_f0	Sie stellen erst einmal sicher , daß er eintritt , indem sie die Arbeitgeberkeywordtag daran hindern , die 35-Stunden-Woche zu unterlaufen . 
Arbeitgeber_s6577_f0	Die 580-Mark-Regelung komme sowohl den Wünschen der Arbeitgeberkeywordtag wie der Arbeitnehmer , insbesondere berufstätiger Frauen und Mütter , entgegen , sagte Westerwelle . 
Arbeitgeber_s6789_f0	Die von der SPD geplante Entlastung , die sowohl Arbeitnehmern als auch Arbeitgebernkeywordtag zugute komme , sei umso wichtiger , da es `` Unkenrufe aus der Bevölkerung '' gebe , in denen über die 1996 steigenden Sozialbeiträge zur Renten- , Kranken- und Pflegversicherung geklagt werde . 
Arbeitgeber_s7960_f0	Arbeitgeberkeywordtag wollen Nürnberger Instrumente stimmen 
Arbeitgeber_s7965_f0	Die Arbeitgeberkeywordtag fordern von Bonn eine grundsätzliche Reform der Arbeitsmarktpolitik . 
Arbeitgeber_s7967_f0	Dies sagte der Sprecher der Arbeitgeberkeywordtag in der BA-Selbstverwaltung , Josef Siegers , im Gespräch mit der FR . 
Arbeitgeber_s7976_f0	Noch in anderer Hinsicht tut sich für die Arbeitgeberkeywordtag ein Dilemma auf . 
Arbeitgeber_s8179_f0	Köbele zeiht Arbeitgeberkeywordtag des Mißbrauchs der EU 
Arbeitgeber_s8188_f0	Köbele warf den Arbeitgebernkeywordtag vor , ihnen gelte der `` Lohnsklave '' als das Ideal der Zukunft . 
Arbeitgeber_s8189_f0	Wenn sie - wie Hauptgeschäftsführer von Gesamtmetall , Dieter Kirchner - das deutsche Tarifsystem durchbrechen wollten , stünden die Arbeitgeberkeywordtag nicht mehr auf dem Fundament des Grundgesetzes . 
Arbeitgeber_s8567_f0	Erstaunt über die Wissenslücken zeigten sich Arbeitgeberkeywordtag und Gewerkschaften . 
Arbeitgeber_s8578_f1	In allen übrigen Ländern teilen sich Arbeitgeberkeywordtag und Arbeitnehmer den Beitrag - und die Arbeitgeberkeywordtag erhalten zum Ausgleich für ihre jährlich 288 Mark im Osten und 352,80 Mark im Westen den zusätzlichen Werktag . 
Arbeitgeber_s8587_f0	So lagen etwa dem Maschinenbauunternehmen Phoenix bei Detmold , mit 2500 Beschäftigten einer der größtenkeywordtag Arbeitgeberkeywordtag in Lippe , zunächst noch keine Anträge auf Freistellung vor . 
Arbeitgeber_s8994_f0	Eine Entlastung der Sozialbeiträge würde allen Arbeitnehmern und Arbeitgebernkeywordtag zugute kommen . 
Arbeitgeber_s10088_f0	Gottschols Vorgänger soll Krise bei Arbeitgebernkeywordtag meistern 
Arbeitgeber_s10101_f0	Darauf seien die Arbeitgeberkeywordtag in den Verhandlungen über die Fortsetzung der Tarifverträge zur Beschäftigungssicherung nicht eingegangen . 
Arbeitgeber_s10134_f0	So hätten die `` Kollegen '' von der GGLF in strategischer Weitsicht schon in den 70er Jahren einen Schritt in die Zukunft gemacht , als sie mit den Arbeitgebernkeywordtag eine europäisch gültige Absprache über die Arbeitszeit von Landarbeitern vereinbart hätten , sagte er . 
Arbeitgeber_s10137_f0	Stolz ist sie auch darauf schon frühzeitig die `` kreative Politik der Sozialpartnerschaft '' mit den Arbeitgebernkeywordtag betrieben zu haben . 
Arbeitgeber_s10242_f0	Töpfer versicherte , die Bundesregierung bekenne sich trotz Kritik der Arbeitgeberkeywordtag zum Gesetzentwurf . 
Arbeitgeber_s10243_f0	DGB-Chef Dieter Schulte lobte das vergangene Woche von der IG Metall vorgeschlagene `` Bündnis für Arbeit '' und mahnte eine `` Bringschuld '' der Arbeitgeberkeywordtag an : 
Arbeitgeber_s10412_f0	Flexibel sind sie schon , die Arbeitgeberkeywordtag , vor allem was ihre eigene Personalpolitik anbelangt . 
Arbeitgeber_s10414_f0	Die Frage ist nur : Leiden maßgebliche Vertreter der Arbeitgeberkeywordtag an Gedächtnisschwund - oder ist der Verband in so desolatem Zustand , daß nur noch der Griff zum Altbewährten das endgültige Fiasko abzuwenden verspricht ? 
Arbeitgeber_s10420_f0	Es gab Dumpingangebote in Tarifrunden , es folgte ein Novum der Tarifgeschichte , als die Arbeitgeberkeywordtag 1993 von sich aus die Tarifverträge kündigten . 
Arbeitgeber_s12752_f0	Gewerkschaftsbund und Arbeitgeberkeywordtag erzielen Einigung über Mindestrecht / 
Arbeitgeber_s12762_f0	Es wäre die erste erfolgreiche Anwendung dieses neuen Verfahrens , das die Ausarbeitung eines europäischen Gesetzes Gewerkschaften und Arbeitgebernkeywordtag überläßt , während sonst die nationalen Regierungen den Ton angeben . 
Arbeitgeber_s13785_f0	Auch die Gewerkschafts-Klage über die `` Untätigkeit von Politik und öffentlichenkeywordtag Arbeitgebernkeywordtag , die es zu einem Reformstau im öffentlichen Dienst '' hätten kommen lassen , stimmt mit der großherzoglichen Mahnung überein , `` übernommene Einrichtungen und Vorschriften den modernen Verhältnissen anzupassen '' . 
Arbeitgeber_s14805_f0	Der Entwurf einer neuen Datenschutzrichtlinie verbot es , daß Kirchen , Arbeitgeberkeywordtag und Staat Daten miteinander austauschen . 
Arbeitgeber_s15218_f0	Arbeitnehmer , die sich ihre Kündigung durch Zahlungen des Arbeitgeberskeywordtag `` vergolden '' lassen , müssen mit einer Sperre des Arbeitslosengeldes rechnen . 
Arbeitgeber_s15240_f0	Das Bundessozialgericht ( BSG ) hat am Donnerstag in Kassel entschieden , daß Arbeitnehmer , die sich ihre Kündigung vom Arbeitgeberkeywordtag `` vergolden '' lassen , mit einer Sperre des Arbeitslosengeldes rechnen müssen . 
Arbeitgeber_s15246_f0	Mit der jetzigen Entscheidung wird aber festgestellt , daß nicht nur der klassische Aufhebungsvertrag zu einer Sperre des Arbeitslosengeldes führen kann , sondern daß auch `` Vereinbarungen '' , die neben einer offiziellen Kündigung getroffen wurden und in denen sich der Mitarbeiter ( meist gegen Zahlung seitens des Arbeitgeberskeywordtag ) mit der Kündigung einverstanden erklärt , als Auflösung des Arbeitsverhältnisses gelten können . 
Arbeitgeber_s15945_f0	Arbeitgeberkeywordtag fordern vier reale Nullrunden 
Arbeitgeber_s15947_f0	Die Arbeitgeberkeywordtag halten das von IG-Metall-Chef Klaus Zwickel angeregte `` Bündnis für Arbeit '' nur für finanzierbar , wenn es eine vierjährige Pause bei Reallohnerhöhungen gibt . 
Arbeitgeber_s15948_f0	Die von Zwickel geforderten 330 000 zusätzlichen Stellen würden Mehrkosten von insgesamt 50 Milliarden Mark verursachen , heißt es in einer internen Analyse der Arbeitgeberkeywordtag , die der dpa vorliegt . 
Arbeitgeber_s16598_f0	Auch bundespolitisch gibt es aus unserer Sicht zu dem Weg einer zwischen Arbeitgebernkeywordtag , Gewerkschaften , Bundesbank und Staat abgestimmten Wirtschaftspolitik keine erfolgsversprechende Alternative , die dem Dreiklang sozialdemokratischer Wirtschaftspolitik entsprechen würde . 
Arbeitgeber_s18227_f0	Die inzwischen zur Tradition gewordenen `` Kanzlergespräche '' Kohls mit den Spitzen von Arbeitgebernkeywordtag und Arbeitnehmern sind ebenfalls eine Idee aus Scharpings `` Regierungsprogramm 94 '' , die der Kandidat als `` Beschäftigungspakt gegen Massenarbeitslosigkeit '' gefordert hatte . 
Arbeitgeber_s19649_f0	`` Der avisierte Dreierpakt zwischen Politik , Arbeitgebernkeywordtag und Gewerkschaft wird mit Sicherheit bei den Tarifverhandlungen für die Chemieindustrie eine wichtige Rolle spielen '' , sagt Hubertus Schmoldt , der Vorsitzende der IG Chemie-Papier-Keramik . 
Arbeitgeber_s19893_f0	Gerade die deutschen Konzerne prägen noch die autoritäre Einstellung des Arbeitgeberskeywordtag `` gegen seine abhängig Beschäftigten '' , ein hierarchisches Denken , das Eigeninitiative und Selbstbestimmung der mitarbeitenden Menschen unterbindet . 
Arbeitgeber_s19897_f0	Wer als Arbeitgeberkeywordtag die arbeitenden Menschen immer noch als Gegner ansieht und zu einem partnerschaftlichen Miteinander nicht bereit ist , sägt am Ast , auf dem wir alle sitzen . 
Arbeitgeber_s19913_f0	Dieser darf durch Nachlässigkeit der Arbeitgeberkeywordtag nicht gefährdet werden . 
Arbeitgeber_s19960_f0	Wir appellieren an die Sozialpartner sowie an die öffentlichenkeywordtag Arbeitgeberkeywordtag , Maßnahmen zur Förderung der Teilzeitarbeit , der Jahres- und Lebensarbeitszeit , Unterbrechungsmöglichkeiten der beruflichen Tätigkeiten , beispielsweise durch ein Sabbatjahr und bezahlte Freistellungen zur Förderung der beruflichen Qualifizierung , mit weiteren Formen der Arbeitszeitverkürzung zu kombinieren . 
Arbeitgeber_s20403_f0	Arbeitgeberkeywordtag , die von der billigen Arbeitskraft illegaler Ausländer profitierten , müßten bei Aufdeckung außer den Bußgeldern auch den Betroffenen eine Art Abfindung zahlen , forderte er . 
Arbeitgeber_s21003_f0	Die Zusage des Arbeitgeberskeywordtag auf Erstattung der Umzugskosten beinhalte im Zweifel auch den Rückumzug , entschied das Bundesarbeitsgericht ( BAG ) in einem am Montag in Kassel veröffentlichten Urteil ( Az. : 5 AZR 216 / 94 ) . 
Arbeitgeber_s21008_f0	Seine Bank wollte die Filiale in Hongkong schließen und hatte ihm `` empfohlen '' , Angeboten anderer Arbeitgeberkeywordtag näherzutreten . 
Arbeitgeber_s21159_f0	Wir informieren dann die Arbeitgeberkeywordtag - die ja immer sagen , daß sie gegen Lohndumping sind . '' 
Arbeitgeber_s22243_f0	Im Gegenzug verlangt der Gewerkschafter von den Arbeitgebernkeywordtag die Zusage , in den nächsten drei Jahren auf betriebsbedingte Kündigungen zu verzichten , 300 000 zusätzliche Arbeitsplätze zu schaffen , 30 000 Langzeitarbeitslose einzustellen sowie die Zahl der Lehrstellen um fünf Prozent per annum zu steigern . 
Arbeitgeber_s22501_f0	Das Klagelied der Arbeitgeberkeywordtag ist bekannt . 
Arbeitgeber_s22517_f0	Somit hätten dann auch die Arbeitgeberkeywordtag die Möglichkeit , die IG Metall beim Wort zu nehmen . 
Arbeitgeber_s22531_f0	Über diese sollten sich die Beschäftigten selbst , vor allem aber die Arbeitgeberkeywordtag und die Betriebs- beziehungsweise Personalräte informieren . 
Arbeitgeber_s24254_f0	`` Empörung '' und `` Unverständnis '' herrscht unter den Beschäftigten des Deutschen Gewerkschaftsbundes ( DGB ) über den eigenenkeywordtag Arbeitgeberkeywordtag . 
Arbeitgeber_s24867_f0	Arbeitgeberkeywordtag zerstritten 
Arbeitgeber_s26835_f0	So auch die Bitte der Gewerkschaften , Sozialverbände und Behindertenorganisationen , jene Ausgleichsabgabe drastisch zu erhöhen , die Arbeitgeberkeywordtag dafür zahlen müssen , wenn sie nicht wie vorgeschrieben sechs Prozent ihrer Stellen mit Behinderten besetzen . 
Arbeitgeber_s29351_f0	Der Arbeitgeberkeywordtag kann sie von den im Sozialplan vorgesehenen Abfindungszahlungen ausschließen , bestätigte das Bundesarbeitsgericht ( BAG ) mit zwei jetzt veröffentlichten Urteilen . 
Arbeitgeber_s29352_f0	Kündige ein Angestellter selbst , verlierekeywordtag der Arbeitgeberkeywordtag unter Umständen einen Mitarbeiter , den er für eine `` geordnete Durchführung der Betriebsänderung '' noch benötige , sagten die Richter . 
Arbeitgeber_s29353_f0	Zudem könne der Arbeitgeberkeywordtag davon ausgehen , daß Mitarbeiter , die selbst kündigen , eine neue Stelle gefunden und geringere Nachteile als gekündigte Mitarbeiter hätten . 
Arbeitgeber_s29354_f0	Ausnahmen gelten nur , wenn der Arbeitgeberkeywordtag zur Kündigung `` veranlaßt '' hat . 
Arbeitgeber_s30484_f0	Auch wenn die tatsächliche Jobabwanderung in ihrer Gesamtheit derzeit meist weit übertrieben dargestellt wird , sind die Drohungen der Arbeitgeberkeywordtag in manchem Einzelfall durchaus real . 
Arbeitgeber_s30568_f0	Kern der Reform ist eine Verfassungsreform , mit der eine strengere Kontrolle der bislang paritätisch von Gewerkschaften und Arbeitgebernkeywordtag verwalteten Sozialversicherung durch das Parlament erreicht werden soll . 
Arbeitgeber_s33448_f0	Einkauf beim Arbeitgeberkeywordtag 
Arbeitgeber_s33452_f0	Mit dem Guthaben können sie nur beim eigenenkeywordtag Arbeitgeberkeywordtag einkaufen . 
Arbeitgeber_s34848_f0	So sei auf der Basis des Betriebsverfassungsgesetzes eine schnelle und unbürokratische Klärung des Sachverhalts über eine sogenannte Einigungsstelle möglich - notfalls auch gegen den Willen des Arbeitgeberskeywordtag . 
Arbeitgeber_s35062_f0	Oder sollen sie sich öffnen , auch mit Arbeitgebernkeywordtag in Dialog treten , mehr Gestaltungsmacht sein wollen ? 
Arbeitgeber_s35069_f0	Das Kräfteverhältnis zwischen Arbeitgebernkeywordtag und Arbeitnehmern hat sich geändert . 
Arbeitgeber_s35076_f0	Mit Verve betreiben Arbeitgeberkeywordtag und Bundesregierung das Rollback . 
Arbeitgeber_s35085_f0	Und der Kreis jener Arbeitgeberkeywordtag wird größer , die ohne tarifliche Einengung gut zu leben verstehen und die das gewerkschaftliche Menetekel einer `` Atomisierung '' der Tariflandschaft nicht schreckt . 
Arbeitgeber_s35089_f0	In Ostdeutschland praktizieren Arbeitgeberkeywordtag Tarifflucht , indem sie aus dem Arbeitgeberverband austreten oder gar nicht erst dazustoßen . 
Arbeitgeber_s35203_f0	Damit versucht der `` Australian Council of Trade Unions '' ( ACTU ) den in der Wirtschaft zunehmenden Trend zu direkt zwischen Arbeitgebernkeywordtag und -nehmern ausgehandelten Einzelverträgen aufzuhalten . 
Arbeitgeber_s35229_f0	Allerdings haben sich CRA , Comalco und die anderen Unternehmen mit der Bevorzugung von Einzelverträgen durchaus an das von der Labor-Regierung 1991 verabschiedete neue Gesetz zur Regelung der Beziehungen zwischen Arbeitgebernkeywordtag und -nehmern gehalten . 
Arbeitgeber_s36255_f0	Anderes gilt für diejenigen , die nach 1995 eine neue Mitgliedschaft begründen , zum Beispiel durch Wechsel des Arbeitgeberskeywordtag oder durch Eintritt ins Berufsleben . 
Arbeitgeber_s36257_f0	Der neue Arbeitgeberkeywordtag muß innerhalb von zwei Wochen die Bescheinigung der gewählten Krankenkasse bekommen und danach dann den Beschäftigten anmelden . 
Arbeitgeber_s36263_f0	Der Arbeitgeberkeywordtag darf diese Entscheidung nicht beeinflussen . 
Arbeitgeber_s36265_f0	War er vorher nirgends versichert , bestimmt der Arbeitgeberkeywordtag . 
Arbeitgeber_s36892_f0	Er und Hauff waren deshalb bereits 1995 in einem Zivilverfahren zu jeweils 1,5 Millionen Mark Schadenersatz an ihrenkeywordtag früherenkeywordtag Arbeitgeberkeywordtag verurteilt worden . 
Arbeitgeber_s37470_f0	Von zusätzlichen 100 Mark Lohnkosten des Arbeitgeberskeywordtag kämen bei einem ledigen Industriefacharbeiter im Durchschnitt nur 36 Mark wirklich an , rechnete er vor , `` und auch die fließen nicht einmal vollständig in den privaten Verbrauch '' . 
Arbeitgeber_s38188_f0	Die noch fast 25 000 Beschäftigten erhaltenkeywordtag einen neuen Arbeitgeberkeywordtag . 
Arbeitgeber_s38593_f0	Was die Flexibilität angeht , sieht Friedrich ausdrücklich gerade auch bei den Arbeitgebernkeywordtag Nachholbedarf . 
Arbeitgeber_s39510_f0	Werkeywordtag vom ehemaligenkeywordtag Arbeitgeberkeywordtag eine Abfindung erhältkeywordtag , hat seit April unter Umständen weniger Arbeitslosengeld auf dem Konto . 
Arbeitgeber_s40033_f0	Am 1. Januar sind rund 300 Mobil-Beschäftigte der Sparten Kraft- und Brennstoffe sowie Services zu BPkeywordtag alskeywordtag neuem 	Arbeitgeber 	gewechselt . 
Arbeitgeber_s40188_f0	Ganz anders bei Himstedtskeywordtag neuem Arbeitgeberkeywordtag , der sich zum Beispiel im Herbst am Verkauf des brandenburgischen Städtchens Liebenberg versuchte . 
Arbeitgeber_s40243_f1	Im Verbandsorgan 	Arbeitgeber 	fordert er , die Regelaltersgrenze von derzeit 65 Jahren bis 2005 auf 67 zu erhöhen und zugleich das Standardrentenniveau stufenweise auf 65 Prozent zu senken . 
Arbeitgeber_s41130_f0	Er sieht Zugeständnisse der Belegschaft bei Urlaubs- und Weihnachtsgeld und von seiten der Arbeitgeberkeywordtag eine Beschäftigungsgarantie bis Oktober 1998 vor . 
Arbeitgeber_s41715_f0	Ihrkeywordtag Lohnkeywordtag kostetkeywordtag den Arbeitgeberkeywordtag nicht die Welt . 
Arbeitgeber_s42736_f0	Als 1966 die Ableger zur Siemens AG zusammengefaßt werden , istkeywordtag erkeywordtag längst derkeywordtag größtekeywordtag privatekeywordtag 	Arbeitgeber 	hierzulandekeywordtag . 
Arbeitgeber_s43446_f0	Dadurch wollen sie verhindern , daß die Arbeitgeberkeywordtag die Billigjobs ganz streichen , weil sie zu unattraktiv würden . 
Arbeitgeber_s43454_f0	Einig ist man sich in Berlin und Düsseldorf auch , daß parallel zu einer Reform die sogenannten Scheinselbständigen ebenfalls sozialversicherungspflichtig werden müßten , um Ausweichreaktionen der Arbeitgeberkeywordtag zu verhindern . 
Arbeitgeber_s47135_f0	Dagegen wurde dem FDP-Abgeordneten Dieter Thomae zufolge keine Einigung in der Frage erzielt , die Arbeitnehmer künftig einen höheren Anteil als die Arbeitgeberkeywordtag zahlen zu lassen . 
Arbeitgeber_s47137_f0	Bisher werden die Beiträge je zur Hälfte von Arbeitgebernkeywordtag und Arbeitnehmern getragen . 
Arbeitgeber_s47195_f0	Bei den Beratungen in Bonn blieb dagegen offen , ob künftig bei Beitragssatzanhebungen der Krankenkassen die Arbeitnehmer stärker zur Kasse gebeten werden sollen als die Arbeitgeberkeywordtag . 
Arbeitgeber_s47199_f0	Wie in Bonn zu erfahren war , erwogen die Koalitionspolitiker , künftige Kassen-Beitragsanhebungen 60 Prozent den Arbeitnehmern und nur zu 40 Prozent den Arbeitgebernkeywordtag aufzubürden . 
Arbeitgeber_s47200_f0	Bisher werden die Beiträge je zur Hälfte von Arbeitgeberkeywordtag und Arbeitnehmer gezahlt . 
Arbeitgeber_s47332_f0	Die FDP verlangt besonders eine Entlastung für die Arbeitgeberkeywordtag bei den Kassenbeiträgen . 
Arbeitgeber_s49907_f0	Der Unterhändler der Opposition forderte Gewerkschaften und Arbeitgeberkeywordtag auf , das neue Gesetz zu akzeptieren . 
Arbeitgeber_s49908_f0	Die Arbeitgeberkeywordtag signalisierten bereits ihre Zustimmung . 
