argumentieren_s262_f1	Zwar , so 	argumentierten 	die Richter , könnten diese Regeln unmittelbar nur auf den organisierten Verbandssport angewandt werden ; 
argumentieren_s1207_f1	Der Zeitung zufolge 	argumentiert 	Bonnkeywordtag , er sei als Käufer und Verkäufer zugleich aufgetreten und der Kauf somit unredlich . 
argumentieren_s3840_f1	Staatschef Soares 	argumentiert 	, daß die Regierung nicht einfach Gesetze mit früheren Laufbahnzusagen kurzfristig ändern könne . 
argumentieren_s7949_f1	`` Das Kartellamt ist grundsätzlich reaktiv '' , 	argumentiert 	SPD-Experte Börnsen . 
argumentieren_s11357_f1	Schon die Softwarefirma Lotus , deren Produkte oft kopiert wurden , 	argumentierte 	, daß Software genau wie ein literarisches Werk dem Urheberrecht als Ganzes unterliegt . 
argumentieren_s13042_f1	Abgeordnete aus Baden-Württemberg , Rheinland-Pfalz und Schleswig-Holstein sollen unter beifälligem Nicken etlicher Teilnehmer 	argumentiert 	haben , der Kompromiß werde die Landtagswahlen im kommenden Jahr `` sehr negativ beeinflussen '' . 
argumentieren_s13088_f1	Abgeordnete aus Baden-Württemberg , Rheinland-Pfalz und Schleswig-Holstein sollen unter dem beifälligen Nicken etlicher Teilnehmer 	argumentiert 	haben , dieser Kompromiß werde die Landtagswahlen im kommenden Frühjahr `` sehr negativ beeinflußen '' . 
argumentieren_s13552_f1	Die Regelung sei nicht rechtmäßig beschlossen worden und verletze ihre Unternehmer-Rechte , 	argumentierten 	siekeywordtag . 
argumentieren_s18404_f1	So hatte der Mann 	argumentiert 	, der Kauf von Alkohol sei auch kein geeignetes Indiz , um eine fehlende Fahrtauglichkeit beurteilen zu können . 
argumentieren_s19994_f1	Kleinkalibrigere Soziologie 	argumentiert 	gerne mit sehr begrenzten `` Fallstudien '' und verspricht deren Ausweitung auf später geplante profunde und flächendeckende Untersuchungen , die dann vielleicht aber doch nie kommen ; 
argumentieren_s20355_f1	Allein internationaler Druck , so 	argumentieren 	Komsic und der als `` Streitschlichter '' der Föderation fungierende Ex-Postminister Christian Schwarz-Schilling , wird Präsident Tudjman dazu bewegen , die Abmachungen über die kroatisch-moslemische Föderation auch wirklich mit Leben zu erfüllen . 
argumentieren_s22519_f1	Der Maschinenbau-Verband etwa 	argumentiert 	, die Lohnabschlüsse müßten eine Weile unterhalb der Produktivitätsentwicklung bleiben , damit die Firmen Speck ansetzen könnten . 
argumentieren_s22938_f1	Bräutigam sei zudem befangen , 	argumentierten 	die Anwälte , weil er 1993 öffentlich bedauert habe , die Bilanz der deutschen Justiz in DDR-Verfahren sei `` mager '' , vor allem bei der Verurteilung der `` Großen '' . 
argumentieren_s25220_f2	`` Sokeywordtag argumentiert mankeywordtag nur , wenn mankeywordtag von den tatsächlichen Problemen und Fragestellungen abhebt und nicht mehr sachbezogen 	argumentiert 	. '' 
argumentieren_s26976_f1	Groteske Elemente in Hoffmanns Geschichten machten es den jungen Lesern leicht , Fiktion und Wirklichkeit zu unterscheiden , 	argumentierte 	siekeywordtag - solange Eltern nicht tatsächlich mit Strafen wie in dem Kinderbuch drohten . 
argumentieren_s28969_f1	Bürgermeister Franz-Joseph Winterhalter 	argumentiert 	wie Axel Mayer vom südwestdeutschen Bund für Umwelt und Naturschutz : Windräder produzieren keine Schadstoffe , sind sauberer als Atom- oder Kohlekraftwerke . 
argumentieren_s31033_f1	Er habe seine Treue nur den USA , nicht aber den UN geschworen , 	argumentierte 	erkeywordtag . 
argumentieren_s34038_f1	Ähnlich 	argumentiert 	sein Kollege Bernd Ellermann vom Branchenzweiten Vereinte . 
argumentieren_s36019_f1	Die Bundesregierung , die dem Verfahren beigetreten ist und die mündliche Verhandlung in Karlsruhe erst erwirkt hat - der Zweite Senat plante ursprünglich keine mündliche Anhörung - 	argumentiert 	vor allem mit dem Rückgang der Asylbewerberzahlen von über 450 000 im Jahr 1992 auf rund 140 000 im vergangenen Jahr . 
argumentieren_s37205_f1	Der Profifußball müsse sich vielmehr `` aus eigener Kraft ernähren '' , 	argumentiert 	der Liga-Fachmann : 
argumentieren_s38728_f1	Belgien , Luxemburg , Irland und die Niederlande hätten bereits angekündigt , den Euro von Januar 1999 an im Verkehr mit der öffentlichen Verwaltung zuzulassen , 	argumentierte 	Starzacherkeywordtag . 
argumentieren_s38966_f1	Im Kontakt mit Behörden und Lieferanten sei das Audit immer häufiger hilfreich , 	argumentiert 	Försterkeywordtag . 
argumentieren_s39959_f1	Denn siekeywordtag 	argumentieren 	, nur wenn die deutsche Regierung durch den Bau einer Transrapid-Verbindung ihr Vertrauen in diese neue Technik demonstriere , ließe sich diese exportieren und damit versilbern . 
