Attentaeter_s1158_f1	Attentäterkeywordtag doch Einzeltäter ? 
Attentaeter_s1406_f1	Die Polizei teilte am Montag mit , der 62jährige Mann sei am Vorabend vor einem Restaurant von Schüssen getroffen worden , die der Attentäterkeywordtag aus einem entführten Taxi abgefeuert habe . 
Attentaeter_s3910_f1	Wie am Montag von amtlicher Seite mitgeteilt wurde , befinde sich darunter auch ein mutmaßlicher Attentäterkeywordtag auf die Gendarmerie in El Abadia , bei dem der Chef der Brigade getötet worden war . 
Attentaeter_s4564_f1	Der Attentäterkeywordtag im Umfeld ultrarechter Organisationen / 
Attentaeter_s4619_f1	`` Wieso konnte der Attentäterkeywordtag mit einer Waffe herumlaufen , bis zur Rednertribüne vordringen , seine Pistole ziehen und drei Kugeln vom Kaliber neun Millimeter abgeben ? '' , fragte der frühere Chef der Spezialeinheit und persönliche Freund Rabins , Sari Awiwi , stellvertretend für viele Israelis . 
Attentaeter_s4620_f1	Eine Antwort könnte sein , daß die Sicherheitskräfte einen möglichen Attentäterkeywordtag unter Arabern , nicht aber unter Juden vermuteten . 
Attentaeter_s4659_f1	Peres , den der Attentäterkeywordtag ebenfalls ermorden wollte , ordnete eine zweitägige Staatstrauer an . 
Attentaeter_s4667_f1	Der 	Attentäter 	, nach Angaben der Polizei ein fanatischer Rechtsextremist und Gegner der Aussöhnung mit den Arabern , wurde sofort festgenommen . 
Attentaeter_s5618_f1	Der Attentäterkeywordtag von Tel Aviv hat Israel auch einen Spiegel vorgehalten . 
Attentaeter_s5724_f1	`` Die Regierung Israels gibt mit tiefer Trauer den Tod des Ministerpräsidenten und Verteidigungsministers Yitzhak Rabin bekannt , der heute von einem Attentäterkeywordtag in Tel Aviv ermordet wurde '' , teilte ein Regierungssprecher vor dem Krankenhaus Journalisten und ängstlich wartenden Israelis mit . 
Attentaeter_s5773_f1	Der 	Attentäter 	, der nicht einmal den Versuch zu fliehen unternahm , wurde festgenommen : Der 27jährige Yigal Amir aus Tel Avivs Diplomatenvorort Herzliya , der an der Bar-Ilan-Universität Jura studierte . 
Attentaeter_s5782_f1	Freunde und Angehörige des Attentäterskeywordtag gaben zwar zu , Amir bei diversen Demonstrationen gegen Rabins Friedenspolitik gesehen zu haben . 
Attentaeter_s5857_f1	Hussein , der in den über vier Jahrzehnten seiner Herrschaft mehr als ein Dutzend Anschlagsversuche überstanden hat , ist sich dieses Risikos um so deutlicher bewußt , als 1951 vor den Augen des halbwüchsigen Thronprätentenden sein Großvater ermordet wurde - König Abdallah , den die Attentäterkeywordtag beschuldigten , Friedenskontakte zur damaligen israelischen Führung unterhalten zu haben . 
Attentaeter_s7638_f1	Der Attentäterkeywordtag erklärte dem Richter , seine Landsleute seien sich nicht bewußt geworden , daß durch Rabins Politik ein palästinensischer Staat geschaffen werde . 
Attentaeter_s8308_f1	Geklärt werden soll , wie der Attentäterkeywordtag trotz der starken Bewachung Rabins durch Sicherheitskräfte in die unmittelbare Nähe des Ministerpräsidenten gelangen konnte . 
Attentaeter_s8311_f1	Mit ihr soll der Attentäterkeywordtag in Kontakt gestanden haben . 
Attentaeter_s8312_f1	Der israelische Geheimdienst Schin Bet plädierte dafür , keinen Anwalt zu dem Attentäterkeywordtag zu lassen , damit geklärt werden könne , ob der Student tatsächlich allein handelte . 
Attentaeter_s8313_f1	Die Polizei nahm inzwischen auch den Bruder des Attentäterskeywordtag fest . 
Attentaeter_s8319_f1	Der unmittelbar nach dem Anschlag festgenommene Attentäterkeywordtag wiederholte vor dem Untersuchungsrichter in Tel Aviv am Montag sein Geständnis . 
Attentaeter_s8358_f1	Schließlich galt es in der `` Operation Havatzelet '' ( eine Blume und ein Mädchenname ) , unter den 5000 Trauergästen nicht weniger als 90 Staatsoberhäupter , Regierungschefs und Minister aus aller Welt vor möglichen Attentäternkeywordtag zu schützen : darunter Ägyptens Hosni Mubarak , die Ministerpräsidenten Marokkos , Maltas , Rußlands , der Türkei , Vertreter aus Oman und Katar ( die beide keine offiziellen Beziehungen zu Israel unterhalten ) , aus so exotischen Ländern wie Kroatien , Kasachstan , Äthiopien , Ghana , Nepal , Papua-Neuguinea oder Albanien . 
Attentaeter_s8390_f1	Am Samstag abend war der Alptraum aller Sicherheitsexperten wahr geworden , `` daß ein Attentäterkeywordtag wie Yona Avrusmi ( der auf den Tag genau zwölf Jahre vor Rabins Tod eine Handgranate in eine Friedensdemonstration in Tel Aviv warf und dabei den Demonstranten Emil Grünzweig tötete ) auftaucht , jemand , der nie politisch auffällig geworden war , den niemand aus den Sicherheitskreisen kennt '' , suchte ein Polizeioffizier nach einer Erklärung für die Tragödie , `` daß irgendein Unbekannter die Plakate , Rabin ist ein Mörder ' oder die Bildmontagen mit Rabin in Gestapo-Uniform in die Tat umsetzt . '' 
Attentaeter_s8801_f1	Die Polizei untersucht , ob der 	Attentäter 	Jigal Amir Ejal-Mitglied ist . 
Attentaeter_s9947_f1	Nach dem Bruder des Attentäterskeywordtag wurde auch seine Verlobte festgenommen . 
Attentaeter_s9949_f1	Der 	Attentäter 	Yigal Amir betonte , er habe allein gehandelt . 
Attentaeter_s12518_f1	Die Familie des Attentäterskeywordtag , bat Rabins Familie am Mittwoch in einem öffentlichen Brief um Vergebung für die Bluttat ihres Verwandten . 
Attentaeter_s15193_f1	Sie hat recht , denn der Attentäterkeywordtag konnte seine mörderische Absicht bestätigt sehen in Likud-Propaganda , die Rabin Nazis gleichsetzte . 
Attentaeter_s15553_f1	Im Garten der Eltern des Attentäterskeywordtag hob die Polizei ein Waffenlager aus , darunter waren Granaten und Sprengsätze . 
Attentaeter_s19283_f1	Nunmehr wird einem Polizeisprecher zufolge weiter untersucht , ob der 	Attentäter 	Yigal Amir den Anschlag allein verübte . 
Attentaeter_s19510_f1	Wie der israelische Rundfunk weiter berichtete , kam der Geheimdienst aber dem späterenkeywordtag 	Attentäter 	Yigal Amir nicht auf die Spur . 
Attentaeter_s19512_f1	Dem Bericht zufolge nannte der Informant Details über den späteren Attentäterkeywordtag , ohne jedoch dessen Namen zu nennen . 
Attentaeter_s19523_f1	Das israelische Fernsehen berichtete , der 25jährige Attentäterkeywordtag und sein zwei Jahre älterer Bruder hätten seit Monaten versucht , Rabin umzubringen . 
Attentaeter_s19831_f1	Die Sicherheitskräfte in Colombo gingen davon aus , daß es sich bei den Attentäternkeywordtag , einer davon eine Frau , um Mitglieder der Separatistenorganisation Befreiungstiger von Tamil Eelam ( LTTE ) handelte . 
Attentaeter_s19836_f1	Offenbar seien die beiden Attentäterkeywordtag allein gewesen , sagte Colombos Polizeichef . 
Attentaeter_s21422_f1	Die drei Festgenommenen , ein 65 und 47 Jahre altes Ehepaar und ein 53jähriger Mann , hätten aber vermutlich keine Verbindung zu den beiden 	Attentätern 	von Oklahoma-City , Tim McVeigh und Terry Nichols . 
Attentaeter_s24698_f1	Ernsthafte und verantwortungsbewußte Menschen in Israel sind genötigt , die Wurzeln des gräßlichen Versagens zu erkennen , das zur Ermordung des israelischen Premiers führte - des ersten , der unter den Kugeln eines Attentäterskeywordtag starb . 
Attentaeter_s24710_f2	Am Abend nach dem Attentat , zumal nach Bekanntgabe der Identität des Attentäterskeywordtag , erschien eine Moderatorin , die uns zu beruhigen suchte und uns zu warten aufforderte , bevor man davon ausgehe , der Attentäterkeywordtag sei Jude ! 
Attentaeter_s45287_f1	Kamen die Attentäterkeywordtag aus Libanon ? 
Attentaeter_s45306_f1	Theoretisch freilich könnten sich die Attentäterkeywordtag von Damaskus auch aus anderen Lagern als aus dem libanesischer Assad-Gegner rekrutieren . 
Attentaeter_s47050_f1	Ein neuer Prozeß könne neue Erkenntnisse bringen , die den alskeywordtag 	Attentäter 	verurteiltenkeywordtag James Earl Ray entlasten und auf andere Verantwortliche deuten . 
Attentaeter_s47051_f1	Martin Luther King war in Memphis im Bundesstaat Tennessee von einem nicht erkannten Attentäterkeywordtag erschossen worden . 
