beantragen_s1444_f0	Im Mai hatte eine Jelzin nahestehende Gruppe die grundsätzliche Prüfung der `` Verfassungsmäßigkeit '' 	beantragt 	. 
beantragen_s2061_f0	Viele der flüchtenden Menschen 	beantragten 	deshalb an der deutschen Grenze Asylkeywordtag `` und belasten dann unsere Verfahren noch zusätzlich zu dem , was wir heute schon haben '' , sagte Läpple . 
beantragen_s2481_f0	Dieskeywordtag war von der Firmenspitze ausdrücklich für den Fall von Akquisitionen 	beantragt 	worden . 
beantragen_s6636_f0	Da ihm in Algerien die Todesstrafe droht , hatte erkeywordtag in Belgien Asylkeywordtag 	beantragt 	. 
beantragen_s7075_f0	Erkeywordtag hatte beim Bundesgericht in Lagos 	beantragt 	, das nigerianische Militärregime für illegal zu erklären . 
beantragen_s7227_f0	Mehr als 100 Städte 	beantragten 	die Gründung von Stadtwerken . 
beantragen_s8712_f0	Die Betriebsgesellschaft von Auerbachs Keller , einem der traditionsreichsten deutschen Restaurants ( siehe FR vom Montag ) , hat beim Leipziger Amtsgericht Gesamtvollstreckungkeywordtag 	beantragt 	. 
beantragen_s8843_f0	Die Staatsanwaltschaft 	beantragt 	sechs Monate Gefängnis . 
beantragen_s12795_f0	Seit 1994 regiert mit absoluter Mehrheit die SPD , die deswegen keinen Anlaß mehr sah , auf die Grünen Rücksicht zu nehmen , als die CDU jetzt die abermalige Rückkehr zu d'Hondt 	beantragte 	. 
beantragen_s13177_f0	In ihrem Namen 	beantrage 	erkeywordtag beim Bezirksgericht von Südflorida eine richterliche Prüfung . 
beantragen_s14531_f0	Wenn wir das Geld tatsächlich zahlen , müssen wirkeywordtag in Dänemark Sozialhilfekeywordtag 	beantragen 	und erhalten wahrscheinlich keine Aufenthaltsgenehmigung mehr . 
beantragen_s14702_f0	Ein Malergeselle hatte bei der Gemeinde Rottenburg eine Reisegewerbekarte 	beantragt 	. 
beantragen_s19388_f0	Für 1996 sind beim Bundesamt für Strahlenschutz erstmals Lufttransporte plutoniumhaltiger Atom-Brennelemente 	beantragt 	. 
beantragen_s27182_f0	Für den nebenberuflich tätigen Kontrolleiter Dieter Stüer , im Hauptberuf Biologe an einem renommierten Bundeswehr-Institut in Koblenz , 	beantragte 	die Anklage eine Haftstrafe von fünf Jahren und sechs Monaten . 
beantragen_s27407_f0	Suspendierungkeywordtag 	beantragt 	
beantragen_s27410_f0	Erkeywordtag 	beantragte 	bei der Landespolizeidirektion , einen Beamten vom Dienst zu suspendieren . 
beantragen_s29648_f0	Erst wenn die deutschen Bekannten länger in Italien bleiben , müssen siekeywordtag bei der Polizeibehörde eine Aufenthaltsgenehmigung 	beantragen 	. 
beantragen_s29727_f0	Als Winnie Mandelas Anwalt am Mittwoch erneut eine Vertagung 	beantragte 	, weil seine Mandantin sich zur Zeit in den USA befinde , verlor der Richter die Geduld und beendete das Verfahren . 
beantragen_s30931_f0	Clintonkeywordtag hatte sieben Milliarden Dollar weniger als die bewilligte Summe 	beantragt 	. 
beantragen_s30996_f0	Bündnis 90 / Die Grünen haben für den 23. November eine Aktuelle Stunde dazu 	beantragt 	. 
beantragen_s31952_f0	Berufstätigekeywordtag können dafür zehn Tage Bildungsurlaub 	beantragen 	. 
beantragen_s34559_f0	Erkeywordtag wolle in Großbritannien Asylkeywordtag 	beantragen 	, berichtete der Observer . 
beantragen_s35094_f0	Neue Berufsbilder wurden gestern 	beantragt 	, sind heute schon überholt und morgen Geschichte . 
beantragen_s36009_f0	Dort , so das Argument , hätte erkeywordtag Asylkeywordtag 	beantragen 	und der Verfolgung entgehen können . 
beantragen_s36428_f0	Erkeywordtag wolle in Großbritannien Asylkeywordtag 	beantragen 	. 
beantragen_s36572_f0	Auf der Generalversammlung im nächsten Juni soll eine Kapitalherabsetzung in der Höhe dieses Volumens 	beantragt 	werden . 
beantragen_s37264_f0	Die Mikromat Werkzeugmaschinenfabrik hat Konkurskeywordtag 	beantragt 	und will auf diesem Weg einen Neustart versuchen . 
beantragen_s37409_f0	Unabhängig davon ist beim Arbeitsamt vorsorglich die Gewährung von Kurzarbeitergeld 	beantragt 	, denn in einer Mitteilung an die Beschäftigten heißt es , daß die Produktion des Polo und des Golf in der nächsten Woche voraussichtlich zum Erliegen komme , wenn in Spanien kurzfristig keine Einigung erzielt werde . 
beantragen_s38043_f0	Die alte Heckert-Gesellschaft mit 550 Mitarbeitern war im Herbst in Schwierigkeiten geraten , nachdem das schwäbische Mutterunternehmen Traub AG ( Reichenbach / Fils ) Vergleichkeywordtag 	beantragt 	hatte . 
beantragen_s39052_f0	Das Bundeskartellamt hat erwartungsmäß 	beantragt 	, die Prüfung von Brüssel in die Bundeshauptstadt zu verweisen . 
beantragen_s39519_f0	Zum zweiten bei Arbeitnehmern , diekeywordtag vor diesem Datum durchgehend beschäftigt waren und innerhalb von rund zwei Jahren nach diesem Termin ihren Job verlieren , dies melden und Hilfekeywordtag 	beantragen 	. 
beantragen_s39736_f0	Gesamtvollstreckungkeywordtag hat das Halbleiterwerk SMI in Frankfurt an der Oder 	beantragt 	. 
