befuerchten_s809_f1	Seitdem 	befürchtet 	die IG Metall einen `` Dammbruch '' . 
befuerchten_s1929_f1	Erkeywordtag 	befürchtet 	, daß Betriebsräte unter Druck gesetzt und Unternehmen gegeneinander ausgespielt werden könnten . 
befuerchten_s3626_f1	Dokokeywordtag 	befürchtet 	erbitterte Schlachten und will sich weiter um eine internationale Militärintervention bemühen . 
befuerchten_s4360_f1	Die Senatoren 	befürchten 	, daß im Falle eines Rücktritts die Schuld für mögliche Neuwahlen der SPD zugeschoben würde . 
befuerchten_s4519_f1	Erkeywordtag habe schon seit längerer Zeit 	befürchtet 	, `` daß irgendein Rattenfänger aus der rechtsradikalen Ecke sich dieses Themas bemächtigt , um Angst zu schüren und Stimmen zu fangen '' , sagte Henkel in einem Interview des Nachrichtenmagazins Focus . 
befuerchten_s5220_f1	In den neuen Bundesländern ist mehr in Gang gekommen , als mankeywordtag noch vor zwei Jahren 	befürchten 	mußte . 
befuerchten_s5359_f1	Die Hochschulrektoren 	befürchteten 	noch mehr Unterschiedlichkeit bei den Studienanfängern und trugen die Gegenforderung nach Hochschuleingangsprüfungen vor . 
befuerchten_s6130_f1	Die Behörden 	befürchten 	, daß bei dem Unwetter weit mehr Menschen ums Leben kamen , da noch immer 200 Menschen als vermißt gelten . 
befuerchten_s6205_f1	Doch dank der Antibiotika sei eine größere Epidemie nicht zu befürchten . 
befuerchten_s6737_f1	Siekeywordtag 	befürchtet 	, die Dose werde trotz einer Recyclingquote von 70 Prozent zum `` umweltpolitischen Prügelknaben '' abgestempelt . 
befuerchten_s7989_f1	Erkeywordtag 	befürchtet 	nämlich , daß eine solche Rentenkürzung - rund elf Prozent im Vergleich zu einem Ruhestand mit 63 Jahren - bei künftigen Sozialplan-Verhandlungen für ältere Beschäftigte über Ausgleichsforderungen auf die Betriebe zurückschlagen werde . 
befuerchten_s8667_f1	Umweltschützerkeywordtag 	befürchten 	angesichts der Vorstellungen über die Ansiedlung neuer Arbeitsplätze , daß sich in dem neuen Quartier ein Bürogebäude ans andere reiht . 
befuerchten_s8919_f1	Der Gynäkologe Professor Hermann Hepp vom Klinikum Großhadern in München 	befürchtet 	nunmehr ungewollte Schwangerschaften . 
befuerchten_s9232_f1	In sehr langfristiger Perspektive mag ein wiedererstarkendes , expansives Rußland 	befürchtet 	werden . 
befuerchten_s9615_f1	Christa Wolf 	befürchtet 	nun das Allerschlimmste für die nahe Zukunft Israels . 
befuerchten_s11620_f1	`` Es ist zu befürchten , daß vor allem Mädchen auf diese Weise von der Beschäftigung mit Mathematik , von der Möglichkeit , sich mit naturwissenschaftlichen und technischen Fragestellungen auseinanderzusetzen , abgehalten werden . 
befuerchten_s12150_f1	Außerdem 	befürchtet 	erkeywordtag , daß hiesige Dividendenwerte von ausländischen Händlern und auch von Banken der Bundesrepublik ex London gehandelt werden . 
befuerchten_s12477_f1	Ljubickeywordtag 	befürchtet 	nach den Erfahrungen anderer Kriege , daß viele der heimkehrenden Soldaten unter dem `` Vietnamsyndrom '' leiden werden . 
befuerchten_s12902_f1	Etwaskeywordtag milderkeywordtag als zunächst 	befürchtet 	fielkeywordtag dennkeywordtag auchkeywordtag der Personalabbau auskeywordtag : 
befuerchten_s12960_f1	Trittinkeywordtag 	befürchtet 	, daß gravierende Menschenrechtsverletzungen vorgeschoben werden und letztendlich ein `` grünes Plazet zu weltweiten Nato-Einsätzen '' erreicht werden soll . 
befuerchten_s13868_f1	Schwere Nachteile für Gesellschaften mit beschränkter Haftung ( GmbH ) 	befürchtet 	Eric Mommer , Vorsitzender des Verbandes der GmbH-Geschäftsführer , falls eine Klage der Brüsseler Kommission beim Europäischen Gerichtshof Erfolg haben sollte . 
befuerchten_s14171_f1	Auch für die gesamte Periode wird ein `` deutlich negatives '' Ergebnis 	befürchtet 	. 
befuerchten_s16278_f1	Neue Bürden 	befürchtet 	erkeywordtag auch bei der Einführung einer einheitlichen europäischen Währung . 
befuerchten_s16998_f1	Für die bevorstehende Wintersaison sind die Aussichten noch trüber , wiekeywordtag Expertenkeywordtag 	befürchten 	. 
befuerchten_s17566_f1	Der Fraktionschef im Landtag , Frieder Lippmann , 	befürchtete 	, die Genossen würden als `` harmlose Würstchen '' untergehen . 
befuerchten_s17843_f1	Nun 	befürchten 	aber einige Experten , daß der beschäftigungs- und sozialpolitische Gestaltungsspielraum nicht nur wegen der öffentlichen Haushaltslage stark eingeschränkt ist , sondern daß die Globalisierung bzw. Internationalisierung von unternehmerischem Handeln , der Produktion sowie der Kapital- und Arbeitsmärkte den Politiken der Nationalstaaten fast vollständig den Garaus macht . 
befuerchten_s17853_f1	Diese Anhängerinnen- und Anhängerschaft ermöglicht eine Politik , die auf Kostensenkung und Abbau sozialer Absicherung setzen kann , ohne daß größerer Widerstand in den eigenen Reihen zu befürchten wäre . 
befuerchten_s18891_f1	Der bündnisgrüne Haushaltssprecher Oswald Metzger sagte , erkeywordtag 	befürchte 	wegen der schwierigen Finanzlage der Kommunen , daß Deutschland die Verschuldungsgrenze des Maastricht-Vertrages nicht werde einhalten können . 
befuerchten_s19175_f1	Verheugenkeywordtag 	befürchtete 	, möglicherweise werde der Besuch in China sogar als eine Art Rehabilitierung betrachtet . 
befuerchten_s19430_f1	Der Indianermissionsrat 	befürchtet 	, daß sich in den Gerichtsverfahren dann diejenigen durchsetzen , die sich Anwälte leisten könnten , und dies seien nicht die oft kleinen indianischen Völker . 
befuerchten_s19782_f1	Es wurde 	befürchtet 	, daß die Schneemassen noch eine weitere Gruppe von 28 Bergsteigern verschüttete , die im selben Camp übernachtet hatte . 
befuerchten_s19811_f1	allerdings hatten die Ärzte eine höhere Opfer-Zahl 	befürchtet 	. 
befuerchten_s20373_f1	Der der katholischen Bischofskonferenz Brasiliens nahestehende Indianermissionsrat 	befürchtet 	, daß sich nach Änderung des Dekrets und Einführung des Widerspruchsrechts die Indianer in den dann folgenden juristischen Verfahren nicht durchsetzen können . 
befuerchten_s21166_f1	Zudem 	befürchtet 	Wiesehügelkeywordtag `` eine Pleitewelle beim Mittelstand , wie wir sie noch nie erlebt haben . 
befuerchten_s21577_f1	Es wurde 	befürchtet 	, daß von ihnen noch weit mehr getötet wurden . 
befuerchten_s22067_f1	Mantelli hatte mit methodologischen Erklärungen eingeetzt , die Langeweilekeywordtag 	befürchten 	ließen ; 
befuerchten_s22365_f1	Der Tankstellenverband beklagt `` eine ruinöse existenzbedrohende Wettbewerbssituation , die auf Dauer das Ausscheiden einer ganzen Anbietergruppe aus dem Markt 	befürchten 	läßt '' . 
befuerchten_s23208_f1	Führende Unionspolitiker 	befürchten 	, daß eine atmosphärische Annäherung der CDU an die PDS letztere mittelfristig salonfähig machen könnte . 
befuerchten_s23387_f1	Die Gemeinden 	befürchten 	, daß die Länder auch bei den Zinsen derart verfahren könnten und sie belastet werden . 
befuerchten_s23665_f1	In Deutschland , dem wichtigsten Absatzland , wird gar ein Umsatzrückgang von 25 Prozent 	befürchtet 	- fast drei Millionen Flaschen weniger als im vergangenen Jahr . 
befuerchten_s23853_f1	Die Justiz hatte vor dem Prozeß in Memmingen besondere Sicherheitsmaßnahmen getroffen , da siekeywordtag nach eigenen Angaben Anschläge von Neonazis 	befürchtete 	. 
befuerchten_s24957_f1	Siekeywordtag 	befürchtet 	eine allgemeine Senkung des Lohnniveaus , zumal eine neue niedrigere Tarifgruppe nicht nur für Beschäftigte ausländischer Firmen auf den Baustellen , sondern auch für die deutscher Unternehmen gelten würde . 
befuerchten_s25154_f1	Siekeywordtag 	befürchten 	, dadurch könne das ohnehin geschwächte Wachstum zum Erliegen gebracht werden . 
befuerchten_s26424_f1	`` Wer an deutschen Universitäten abgewiesen wird , wendet sich möglicherweise an eine dieser in Deutschland nicht anerkannten Hochschulen , die auch keinen anerkannten Abschluß verleihen kann '' , 	befürchtet 	Werner Becker , HRK-Informationsreferent . 
befuerchten_s26837_f1	Angriff auf `` Würde des Lebens '' 	befürchtet 	
befuerchten_s27155_f1	Außerdem 	befürchtet 	siekeywordtag , daß der `` Fortschritt bei den Lohnstückkosten '' , die zuletzt um 2,5 Prozent sanken , durch den Tarifabschluß , der jetzt erst voll wirksam werde , und den schwereren Sozialversicherungslasten 1996 wieder zunichte gemacht werde . 
befuerchten_s27644_f1	`` Jetzt ist meine Tochter 16 Jahre alt , und es ist ein ähnlicher Alptraum zu befürchten . '' 
befuerchten_s27709_f1	Scharping und andere Gegner der von Lafontaine favorisierten Änderung 	befürchten 	, daß sich die SPD im Bundestag gezwungen sehen würde , eine deutsche Beteiligung an einer Friedenssicherung abzulehnen , wenn das Konzept der Bundesregierung auch den Einsatz von `` Tornados '' einschließt . 
befuerchten_s27925_f1	Daß ihn die Mehrheit im Stich läßt , mußte Juppékeywordtag nicht 	befürchten 	. 
befuerchten_s28074_f1	Klägerkeywordtag 	befürchten 	ein `` Absaufen '' der Grube 
befuerchten_s28079_f1	Dabei berufen sie sich vor allem auf Gutachten von Experten über den ehemaligen Salzstock , in denen von `` 24 Tropfstellen , Tümpeln und Sumpfstellen '' die Rede ist , die ein `` Absaufen der Grube und damit das Freiwerden der radionukleiden Stoffe in die Umwelt 	befürchten 	lassen '' . 
befuerchten_s28607_f1	Daskeywordtag 	befürchtet 	der Sprecher jedoch nicht . 
befuerchten_s28882_f1	Manche in Brüssel 	befürchten 	nach profil-Angaben bereits , die Funken , die Haider in Österreich schlage , könnten in der Ära nach Helmut Kohl auch auf Deutschland überspringen . 
befuerchten_s31272_f1	aikeywordtag 	befürchtet 	, daß mindestens 17 von ihnen wegen derselben Morde vor einem Militärtribunal angeklagt werden , für die bereits der nigerianische Schriftsteller Ken Saro-Wiwa und acht seiner Mitstreiter in der vergangenen Woche nach einem unrechtmäßigen Prozeß gehenkt worden waren . 
befuerchten_s32463_f1	Eine bedenkliche Zunahme von Krankheiten bei Kindern , Frauen und Kranken 	befürchtete 	eine Gruppe alliierter Offiziere . 
befuerchten_s33481_f1	Verlust von 10 000 Stellen 	befürchtet 	
befuerchten_s33486_f1	Die Belegschaftsvertreter 	befürchten 	, daß die Verkaufs- und Umbaupläne der Stuttgarter letztlich insgesamt rund 10 000 Arbeitsplätze kosten könnten und entwickeln daher Konzepte und Aktionspläne , um die Traditionsfirma zu verteidigen . 
befuerchten_s33500_f1	Die Belegschaftsvertreter der Zentrale , diekeywordtag das Ende der AEG im Laufe des nächstes Jahres 	befürchten 	, hoffen daher auf Unterstützung der Politiker im Frankfurter Römer für den Kampf um den Standort am Main . 
befuerchten_s33708_f1	Siekeywordtag 	befürchten 	aber , daß sich die SPD im Bundestag dazu gezwungen sehen würde , die deutsche Beteiligung an einer Friedenssicherung abzulehnen . 
befuerchten_s34202_f1	Siekeywordtag 	befürchten 	aber , daß sich die SPD im Bundestag dazu gezwungen sehen würde , die deutsche Beteiligung abzulehnen . 
befuerchten_s35844_f1	Dann sei zu befürchten , daß auch Kanadier und Australier zurückfielen . 
befuerchten_s36037_f1	Am heutigen Montag strahlt die BBC , das öffentlich- rechtliche Fernsehen Großbritanniens , am Abend ein Interview mit der englischen Prinzessin aus , von dem Monarchisten auf der Insel das Schlimmste für die Krone 	befürchten 	. 
befuerchten_s38375_f1	Auch sei zu befürchten , daß der soziale Wohnungsbau durch Mittelkürzungen ausblute . 
befuerchten_s38580_f1	`` Wir werden es tun , glaube ich '' , tat der sozialistische Premier Lionel Jospin kund , nachdem mankeywordtag noch zu Beginn der Woche 	befürchten 	mußte , das Projekt könnte während der von Frankreich erbetenen `` Bedenkzeit '' auf die ganz lange Bank geschoben werden , was im äußersten Fall den termingerechten Beginn der Währungsunion wie auch die Verabschiedung der politischen und institutionellen EU-Reformen ( `` Maastricht II '' ) gefährdet hätte . 
befuerchten_s38706_f1	Ansonsten drohe dem abhängigen Süden eher Gefahr aus den `` Reformstaus '' im Westen und Osten - statt eines neuen mexikanischen `` Tequilaeffekts '' müsse die Dritte Welt `` Bier- oder Wodkaeffekte '' 	befürchten 	. 
befuerchten_s38991_f1	Siekeywordtag 	befürchten 	, von den mächtigen Konzernen wie RWE Energie , Preussenelektra , Bayernwerk und Co. an die Wand gedrängt zu werden , wenn es künftig keine Demarkationsverträge und Ausschließlichkeitsklauseln in Konzessionsverträgen mehr gibt . 
befuerchten_s39090_f1	Das Kartellamt 	befürchtet 	, daß die Konzentration zu Lasten der Kunden geht . 
befuerchten_s39682_f1	Denn siekeywordtag 	befürchten 	, daß Brüssel zu viele Fälle an sich zieht . 
