begruenden_s527_f1	Setzt sich die SPD durch , gerät Deutschlandkeywordtag in den Verdacht , sich hinter der Verfassung zu verstecken , um nicht im Einzelfall 	begründen 	zu müssen , warum es dem Hilferuf der Vereinten Nationen oder eines befreundeten Landes nicht nachkommt . 
begruenden_s539_f1	Wie immer der Bundestag im Einzelfall entscheidet , die hohe parlamentarische Hürde zwingt die Abgeordneten dazu , Zustimmung oder Ablehnung ausführlich zu begründen . 
begruenden_s957_f1	In der Antwort auf ein ANC-Memorandum , mit dem dieserkeywordtag den Abbruch der Gespräche 	begründet 	hatte , warf sie dem ANC vor , den Verhandlungsprozeß absichtlich gestört und `` künstlich '' eine Krisensituation geschaffen zu haben . 
begruenden_s1497_f1	Die Währungshüter in Rom 	begründeten 	die Anhebung der Leitzinsen mit dem jüngsten Druck auf den Wechselkurs der Lira . 
begruenden_s1925_f1	Nach deren Angaben hatte ein Autohaus in Quedlinburg Lohnabschlägekeywordtag ausdrücklich mit Möllemanns Vorhaben 	begründet 	. 
begruenden_s2172_f1	Die laufende Kurzarbeit in Teilen des Konzerns reiche nicht aus , 	begründen 	die Franken ihre Pläne . 
begruenden_s2270_f1	Der größere Verlust wird unter anderem mit den hohen Anlaufkosten für das neue Kopiererprogramm 	begründet 	. 
begruenden_s3795_f1	`` In Zukunft wird die EG-Kommission Vorschläge über Gemeinschaftsmaßnahmen 	begründen 	'' , meinte Bangemann . 
begruenden_s5324_f2	Zuallererst ist dieskeywordtag darin 	begründet 	, daß wir dort gewerkschaftlich nicht oder nicht ausreichend vertreten sind . 
begruenden_s5505_f2	Auf der leeren Bochumer Bühne treiben wüste Potenzgesten die Poesie aus , die bevorzugten Requisiten stammen vom Gemüsemarkt : als Phalluszeichen eingesetzte Mohrrüben ; und Kohlköpfe , diekeywordtag offenbar 	begründen 	sollen , Kohl bläht , warum Jupiter den Beinamen des `` Donnerers '' führt . 
begruenden_s6174_f1	Erkeywordtag 	begründet 	seine Forderung , die nach seinen Angaben vom Kuratorium bereits akzeptiert worden war , mit vergleichbaren Gagen anderer europäischer Kulturmanager . 
begruenden_s6362_f1	Westerwellekeywordtag 	begründete 	diese Forderung am Montag in Bonn damit , daß es nach dem Urnengang am 22. Oktober zu einem `` Machtvakuum '' gekommen sei . 
begruenden_s6916_f2	Daskeywordtag 	begründet 	die Glaubwürdigkeit der Botschaft und trifft das Gemüt auch des Zuschauers daheim im Lehnsessel . 
begruenden_s7358_f1		Begründet 	wird dieskeywordtag mit dem steigenden Angebot . 
begruenden_s7420_f1	Eine Koalition der Verlierer ist vor den Wählern nur zu rechtfertigen , wenn die sachliche Notwendigkeit überzeugend 	begründet 	werden kann . 
begruenden_s7486_f1	Wenn es gelingt , würde es unser Profil schärfen , weil wirkeywordtag 	begründen 	können , warum das mit uns nicht ging . 
begruenden_s7881_f1	Der Reformbedarf wird 	begründet 	mit den Kostensteigerungen im Gesundheitswesen , dem wachsenden Altersdurchschnitt der Bevölkerung und mit Ungerechtigkeiten im Sozialsystem . 
begruenden_s8538_f1	Ebenso spricht für einen aufgeweckten Rechtsstaat , daß die Beurteilung einer früheren Richtertätigkeit im Einzelfall zu treffen und individuell 	begründet 	werden muß . 
begruenden_s8771_f1	Die Staatsanwaltschaft 	begründete 	dieskeywordtag damit , daß das Politbüro nichts unternommen habe , die Situation an der Grenze zu ändern . 
begruenden_s8942_f1	Die Bundesrichter 	begründeten 	ihr Grundsatzurteil damit , daß nach der sogenannten Drittstaatenregelung des 1993 geänderten Asylrechts allein `` der Nachweis der Einreise aus einem sicheren Drittstaat '' entscheidend sei . 
begruenden_s9152_f1	Unter den Standardwerten verloren Hoechst 5,80 Mark , waskeywordtag mit reduzierten Gewinnschätzungen der Analysetochter der Deutschen Bank ( DB Research ) 	begründet 	wurde . 
begruenden_s9241_f1	Spanische Ängste vor dem islamischen Fundamentalismus sind zum guten Teil ohne realen Anlaß und , soweit 	begründet 	, nicht durch Militär zu bewältigen . 
begruenden_s9380_f1	Doch da diese immer wieder `` energisch '' gefordert werden , ohne daß bislang ein durchschlagender Erfolg zu verzeichnen gewesen wäre , sollte mankeywordtag `` Butter bei die Fische '' tun und 	begründen 	, warum eine Reduzierung der Ausgaben dieser Kategorie realistisch ist . 
begruenden_s9462_f3	Der Wunsch des Landes Berlin , die Städtepartnerschaft zu intensivieren , `` neue Traditionen zu begründen '' ( Fanselau ) , müßte effektivere transatlantische Hebel haben . 
begruenden_s10095_f1	Erkeywordtag habe sein Ausscheiden mit seinem Alter und der Doppelbelastung als Unternehmer und Vorsitzender 	begründet 	. 
begruenden_s10253_f1		Begründet 	wird dieskeywordtag mit dem hohen bürokratischen Aufwand . 
begruenden_s10696_f1	Daß Schwulen und Lesben nicht die Heirat im traditionellen Sinn ermöglicht werden soll , 	begründete 	die niedersächsische Regierung mit dem Verfassungsrecht . 
begruenden_s10750_f1	`` Daß Tiere für studentische Praktika gequält und getötet werden , ist ethisch nicht zu vertreten und wissenschaftlich nicht zu begründen '' , sagte der Präsident der Organisation , Wolfgang Apel , am Mittwoch in Bonn . 
begruenden_s10851_f1	Siekeywordtag 	begründet 	ihren Schritt mit dem weltweit herrschenden Überangebot an der krummen Frucht , das die Preise schon bald kräftig drücken könne . 
begruenden_s11792_f1	`` Wenn es den Korps um Aufarbeitung ihrer Geschichte ginge '' , 	begründet 	erkeywordtag seine Kritik , `` könnten sich die heutigen Mitglieder durchaus von NS-belasteten Alten Herren distanzieren . '' 
begruenden_s11839_f1	Werkeywordtag wie er seine eigene Arbeit mit außergewöhnlicher Systematik entwirft und 	begründet 	, scheint zunächst auch wenig Anlaß dafür zu haben . 
begruenden_s12084_f1	Die Fälle von Raubkopien und Musterklau nähmen auch auf Frankfurter Textilschauen eindeutig zu , 	begründet 	die Messegesellschaft die gemeinsam mit dem Verband Gesamttextil und der US-Schutzgemeinschaft TPFA gestartete Initiative . 
begruenden_s12231_f0	Die Amsterdamer Polizei 	begründete 	ihren Schritt mit den aus der Hand gelaufenen IRT-Methoden . 
begruenden_s12378_f0	Das damalige Verbot hatte der Bundesinnenminister damit 	begründet 	, daß die NF auf militantem Wege , durch Bildung eines `` Nationalen Einsatzkommandos '' versuche , ihre Ziele zu erreichen . 
begruenden_s12651_f2	Das Junktim zwischen einer Lösung für Ostslawonien und für Bosnien ist nicht aus der Sache 	begründet 	, sondern nur aus der kroatischen Furcht , den vorerst letzten günstigen Augenblick zu verpassen . 
begruenden_s13155_f1		Begründet 	wurde die Entscheidung damit , beide Parteien hätten nicht genug Unterschriften zusammengebracht , die für eine Anmeldung zu den Wahlen nötig seien . 
begruenden_s13513_f0	Seehoferkeywordtag 	begründet 	die Lockerung des Hanfanbauverbots damit , daß auch deutschen Bauern die Erschließung des Marktpotentials für die Hanfpflanze , ihre vielfältigen Verwendungsmöglichkeiten zur industriellen Verwertung und eventuellen Energiegewinnung zu ermöglichen . 
begruenden_s13558_f1	Die Einreiseverweigerung wurde mit einer erwarteten `` Beeinträchtigung für die öffentliche Sicherheit und Ordnung '' 	begründet 	. 
begruenden_s13758_f0	Händlerkeywordtag 	begründeten 	die positive Tendenz mit der guten Verfassung der europäischen Festverzinslichen . 
begruenden_s14169_f0		Begründet 	wird dieskeywordtag unter anderem mit der Stärke der Mark . 
begruenden_s14391_f1	In dem Lande aber , wo der Papst wohnt und wo theologisch 	begründet 	worden ist , warum Hexen beiderlei Geschlechts zu verbrennen sind , haben sie keine Chance . 
begruenden_s14435_f2	Der einzelne bewegt sich in zahlreichen überindividuellen Zusammenhängen , die er teils frei wählt , teils ohne eigenes Zutun akzeptieren muß und diekeywordtag Rollen- und Verhaltenserwartungen 	begründen 	, denen er unterworfen ist . 
begruenden_s14751_f0	Den Rückgang , der weiter anhalten werde , 	begründet 	ein VW-Sprecher mit der notwendigen Auflösung von Sonderposten aus der Zonenrandförderung . 
begruenden_s14868_f0	Die zum Viag-Konzern gehörende Gruppe 	begründet 	dieskeywordtag mit sinkendem Verkauf von Dosen und Glasverschlüssen . 
begruenden_s14916_f3	Wir erinnern daran , daß auch der New Deal in den USA der 30er Jahre , derkeywordtag den Wohlfahrtsstaat 	begründete 	, gegen Widerstände in der Wirtschaft durchgesetzt werden mußte , obwohl er wirtschaftlicher Vernunft entsprach und eine Phase ökonomischer Prosperität einleitete . 
begruenden_s15013_f0	Auch Finanzminister Theo Waigel ( CSU ) hatte die von ihm angekündigte Einladung der Länderfinanzminister zu einem `` nationalen Stabilitätspakt '' mit der unbefriedigenden Beschäftigungsentwicklung 	begründet 	. 
begruenden_s15034_f0	Seehoferkeywordtag 	begründet 	die Lockerung des Hanfanbauverbots damit , deutschen Bauern die Erschließung des Marktpotentials für die Hanfpflanze sowie ihre vielfältigen Verwendungsmöglichkeiten zur industriellen Verwertung und eventuellen Energiegewinnung zu ermöglichen . 
begruenden_s15066_f0	Die Mannheimer Staatsanwaltschaft 	begründet 	den Vorwurf der Volksverhetzung mit dem Inhalt des Buches `` Der Fall Günter Deckert '' , das Deckert verfaßt haben soll und dessen Vertrieb mittlerweile verboten worden ist . 
begruenden_s15070_f1	Der Haftbefehl wird mit Fluchtgefahr 	begründet 	. 
begruenden_s15129_f0	Seinen Rückzug 	begründete 	der Vier-Sterne-General , der den Golf-Krieg geleitet hatte , zum einen mitkeywordtag privatenkeywordtag Gründenkeywordtag . 
begruenden_s16420_f3	die Einheit des Kinos war in einem kontinuierlichen Feld 	begründet 	, auf dem alle Arten von Filmen entstanden . 
begruenden_s17749_f1	Siekeywordtag ist 	begründet 	in rapiden gesellschaftlichen Veränderungen und in politischen Umbrüchen . 
begruenden_s18082_f3	Wir erinnern daran , daß auch der New Deal in den USA der 30er Jahre , derkeywordtag den Wohlfahrtsstaat 	begründete 	, gegen Widerstände in der Wirtschaft durchgesetzt werden mußte , obwohl er wirtschaftlicher Vernunft entsprach und eine Phase ökonomischer Prosperität einleitete . 
begruenden_s18600_f1	Die öffentlichen Banken , die 1994 Kredite in Höhe von 23 Milliarden US-Dollar gewährten , `` können das Geld nicht mehr an Personen vergeben , die nur an ihren Gewinn denken '' , 	begründete 	Präsident Fernando Henrique Cardoso das neue , ökologisch ausgerichtete Programm . 
begruenden_s18744_f0	Der Vorstand des Bier-Branchenprimus 	begründet 	das enttäuschende Ergebnis mit einem ( ohne Zukäufe ) geringer sprudelnden Absatz , operativem Verlust beim Gerstensaft und einem niedriger als geplant ausgefallenen Mittelzufluß aus der Kapitalerhöhung im Frühjahr . 
begruenden_s18953_f0	Ihren Rücktritt 	begründete 	Sahlinkeywordtag mit dem Wunsch , den Schaden , den die Partei erlitten habe , zu begrenzen . 
begruenden_s19059_f0	Siekeywordtag 	begründet 	dieskeywordtag mit dem Rückgang des Aktienkurses der Firma in jüngster Zeit , weshalb eine damit verbundene Kapitalerhöhung derzeit nicht ratsam erscheine . 
begruenden_s19303_f1	Der Vorbehalt gegen Ellemann-Jensen wurde halboffiziell mit dessen mangelhaftem Französisch 	begründet 	. 
begruenden_s19346_f0	Der Fraktionssprecher der Bündnisgrünen , Joschka Fischer , 	begründete 	den Antrag damit , der Vertreter eines Regimes , das den Mord an Rabin bejubele , sei nicht willkommen . 
begruenden_s20056_f1	Ein anekdotisch-biographischer Auslöser für die Komposition war ein einmal von Lim gehörter Violoncello-Patzer , derkeywordtag die Stimmführerschaft eines von Kristin von der Goltz souverän beherrschten Barockcellos 	begründete 	. 
begruenden_s20765_f1	Daß das Vorhaben `` offensichtlich '' auch noch gegen das Zweite Wohnungsbaugesetz verstoße , 	begründe 	einen doppelten Skandal . 
begruenden_s21246_f0	Nachdem bekanntgeworden war , daß Frankreichs Regierung die Ablehnung des Dänen offiziell mit dessen mangelhaften Kenntnissen der zweiten offiziellen Nato-Sprache neben Englisch 	begründet 	, waren Ellemann-Jensen mehrere Angebote von Sprachschulen zugesandt worden . 
begruenden_s21589_f0	Händlerkeywordtag 	begründeten 	dieskeywordtag mit Spekulationen über eine Zusammenarbeit zwischen Daimler und Chrysler . 
begruenden_s22441_f3	Eine stolze Dynastie , derer zu Blunt , wird sogleich 	begründet 	. 
begruenden_s22637_f0	Zwar 	begründete 	Hamaskeywordtag die Entscheidung mit demographischen Argumenten - selbst wenn sich Hamas gegen die Gründung einer Partei entschiede , wisse man nach den Wahlen , wie viele sich einem Boykott angeschlossen hätten . 
begruenden_s23344_f1	Das Bundesverfassungsgericht habe seine Entscheidung , die Verwendung des Zitats von Kurt Tucholsky nicht generell als strafbar einzustufen , damit 	begründet 	, daß die geltende Rechtslage kein anderes Urteil zulasse . 
begruenden_s23356_f1	Meyerkeywordtag 	begründet 	seinen Schritt mit `` chaotischer Fehlplanung '' im Theaterbetrieb . 
begruenden_s23571_f0	Die Organisation 	begründete 	ihre Entscheidung in der Hauptstadt Colombo damit , daß sich eine entscheidene Schlacht zwischen den Tamilenrebellen und Regierungstruppen anbahne . 
begruenden_s23866_f1	Mit diesem Erwerb , 	begründet 	Schneiderkeywordtag den Deal , erreiche Bayer auf dem Weltmarkt eine wesentlich größere Kundennähe und baue seine US-Kunststoffaktivitäten entscheidend aus . 
begruenden_s23941_f0	Die CDU-Mehrheit 	begründete 	ihre Entscheidung mit dem Zwang zum Sparen . 
begruenden_s23953_f1	Womitkeywordtag wird dieskeywordtag 	begründet 	, wer treibt die Entwicklung voran ? 
begruenden_s27462_f0	Das bundeseigene Unternehmen 	begründet 	dieskeywordtag mit dem Bestreben , die Tarife zu vereinheitlichen . 
begruenden_s27495_f1	In diesen vier Fällen hätte das Landgericht Dresden Rechtsbeugung fehlerhaft verneint , 	begründete 	der BGH sein Urteil . 
begruenden_s27732_f1	Daß diese Qualifizierung auch für Melatonin gelten soll , 	begründen 	die Hersteller damit , daß die Substanz aus Tomaten und Bananen gewonnen werde . 
begruenden_s27779_f1	Generalinspekteur Naumann verstieg sich hingegen zu der Darstellung , Bundeswehrkritiker seien am Niedergang der Wehrpflicht schuld , deren Notwendigkeit erkeywordtag im übrigen vor allem `` militärisch '' 	begründete 	, soll heißen : als Nachwuchsreservoir . 
begruenden_s28054_f0	Beidekeywordtag 	begründeten 	ihr Vorgehen mit dem Hinweis , daß die SPD endlich Klarheit über ihre personellen Entscheidungen brauche und eine fortdauernde Unsicherheit der Partei schaden würde . 
begruenden_s29742_f1	Siekeywordtag muß Optionenkeywordtag 	begründen 	auf die politische Alternative , was mitnichten allein eine Machtfrage ist , sondern eine der Inhalte . 
begruenden_s30440_f1	Beide Länder 	begründen 	dieskeywordtag mit der veränderten sicherheitspolitischen Lage , in der sie , wenn sie sich vertragsgetreu verhielten , anteilsmäßig sehr viel weniger Waffen in der Flankenregion als auf dem Rest ihres Territoriums stationieren dürften . 
begruenden_s30742_f1	Auch Scharping hatte dies nach eigenem Bekunden gespürt und seinen Schritt entsprechend 	begründet 	: 
begruenden_s30771_f1	Nicht die Verhängung der Todesstrafe allein 	begründet 	schon das Verdikt der Rechtsbeugung . 
begruenden_s32112_f1	Die Existenz des Systems `` Erde '' 	begründet 	sich danach auf einem uneigennützigen Verhalten ( Altruismus ) vorangegangener Evolutionsprozesse . 
begruenden_s32143_f1	Bejaht er aber ihre Legitimität und damit die der Abschreckung , diekeywordtag aber nur mit ihrer `` erwiesenen '' oder behaupteten Wirksamkeit zu begründen wäre , stellt er nachträglich den Atomwaffensperrvertrag in Frage . 
begruenden_s34037_f0	Sprecher Uwe Panek 	begründet 	dieskeywordtag vor allem mit der Entwicklung der ambulanten Kosten . 
begruenden_s34119_f1	Die Notmaßnahme der Regierung liegt im Verhalten der Lega Nord 	begründet 	, die ihre mehrheitsbildende Zustimmung zur anstehenden Haushaltsreform von neuen ausländerrechtlichen Regelungen abhängig gemacht hat . 
begruenden_s34164_f1	Justizsprecherin Uta Fölster teilte am Freitag mit , den Befangenheitsantrag des Beschuldigten Günther Schabowski , einst SED-Politbüromitglied und Ost-Berliner SED-Chef , sehe das Gericht als 	begründet 	an . 
begruenden_s34546_f1	Dasa-Chef Manfred Bischoff hatte das Sparprogramm als notwendige Reaktion auf den Dollarkursverfall und die Luftfahrt-Krise 	begründet 	. 
begruenden_s34870_f2	So redete sich Kaltenbrunner , `` einer , der seine Karriere auf Leichenbergen 	begründet 	hatte , damit heraus , daß er sagte , er hätte doch immer so viel mit der Verkehrspolitik zu tun gehabt . 
begruenden_s35614_f1	Aus demselben Grund sind später gut 	begründet 	die Verjährungsdaten bei NS-Verbrechen geändertkeywordtag worden . 
begruenden_s36255_f3	Anderes gilt für diejenigen , diekeywordtag nach 1995 eine neue Mitgliedschaft 	begründen 	, zum Beispiel durch Wechsel des Arbeitgebers oder durch Eintritt ins Berufsleben . 
begruenden_s36562_f0		Begründet 	wird dieskeywordtag mit ungelösten Steuer- und Bewertungsproblemen bei der geplanten Fusion mit Krupp . 
begruenden_s37545_f0	Ihren Ausstieg aus dem Erdnuß-Geschäft 	begründen 	die Bielefelder mit `` inhaltlichen Erwägungen '' . 
begruenden_s38302_f1	In Zukunft muß jede Eintragung 	begründet 	werden . 
begruenden_s38945_f1	Nationale Politik verliere durch die Globalisierung der Wirtschaft an Bedeutung , 	begründen 	die Frankfurter ihren Schritt , gleichzeitig wachse die Eigenverantwortung international tätiger Unternehmen . 
