Belegschaft_s1702_f0	Er lasse sich von der Belegschaftkeywordtag überprüfen auf Verwirklichung von Artikel 48 der Landesverfassung , Recht auf Arbeit . 
Belegschaft_s1730_f0	`` Die Beteiligten müssen sich zusammensetzen '' , also Treuhand , Eigentümer , Landesregierung und Belegschaftkeywordtag , möglichst noch im Juli . 
Belegschaft_s1809_f0	Hinter sich die Transparente `` Stopp der Arbeitsplatzvernichtung '' und `` Wir haben nichts mehr zu verlieren außer unseren Arbeitsplätzen '' , vor sich das Mikrofon und eine Belegschaftkeywordtag , die Angst vor morgen hat . 
Belegschaft_s1838_f0	Ein Teil der Belegschaftkeywordtag holte Klose mit Fahnen und Transparenten beim Gewerkschaftshaus ab . 
Belegschaft_s1927_f0	Ein Abweichen von den zwischen Gewerkschaften und Arbeitgebern ausgehandelten Tarifen soll aber nur mit Zustimmung der betrieblichen Interessenvertreter der Belegschaftkeywordtag möglich sein . 
Belegschaft_s2272_f0	1991 wurde die Belegschaftkeywordtag um etwa 200 auf 4000 Männer und Frauen verringert . 
Belegschaft_s2989_f0	Er deutet nur an , daß der derzeitige Ordereingang `` in einzelnen Bereichen nicht ausreicht , um die Belegschaftkeywordtag voll zu halten '' . 
Belegschaft_s2992_f0	Nur durch die erstmalige Einbeziehung der Töchter in der Ex-DDR , die mit noch 18 000 Beschäftigten im laufenden Geschäftsjahr sechs Milliarden Orders und vier Milliarden Umsatz ( davon 80 Prozent mit öffentlichen Kunden ) hereinholen sollen , wuchs die Belegschaftkeywordtag in den ersten acht Monaten um 13 000 auf weltweit 415 000 Männer und Frauen . 
Belegschaft_s6573_f0	Viele Betriebe stellenkeywordtag ganze Belegschaftenkeywordtag auf dieser Basis einkeywordtag . 
Belegschaft_s8256_f0	Belegschaftkeywordtag schrumpft / 
Belegschaft_s8878_f0	Die Sozialverträglichkeit für die Belegschaftenkeywordtag müsse gewahrt und die Kapitalvernichtung in den Unternehmen minimiert werden . 
Belegschaft_s9097_f0	Die Belegschaftkeywordtag der Fabrik in der Stadt Saporoschje wurde nach Auslaufen des Chlors am Montag abend evakuiert . 
Belegschaft_s10260_f0	Als Vorteile nennt er unter anderem geringere Kosten durch Optimierung , aber auch eine Aufwertung des Firmenimages bei Kunden , in der Belegschaftkeywordtag und der Öffentlichkeit . 
Belegschaft_s11191_f0	Die Belegschaftenkeywordtag seien sehr verunsichert , heißt es in der Hamburger IG-Metall-Bezirksleitung . 
Belegschaft_s12905_f0	Weil gleichzeitig jenseits der Grenzen 4000 Jobs ( davon 3000 durch Neuerwerbungen ) hinzukamen , schrumpfte die gesamte Belegschaftkeywordtag `` nur '' um 3000 auf 373 000 Köpfe . 
Belegschaft_s13979_f0	Mit ständig schrumpfender Belegschaftkeywordtag war B & W seit den großen Tagen in den fünfziger Jahren immer häufiger ins Schlingern geraten . 
Belegschaft_s14139_f0	Nicht betriebsnotwendige Sparten wurden veräußert , die Belegschaftkeywordtag bisher ohne Entlassungen vermindert . 
Belegschaft_s14142_f0	Damit beschäftigen die Wiesbadener , die es zu Hause auf eine Belegschaftkeywordtag von rund 600 Menschen bringen , in Ungarn 1400 Leute und befriedigen drei Viertel des dortigen Sekt-Durstes . 
Belegschaft_s14736_f0	Die höheren Erlöse wurden von einer kleinerenkeywordtag Belegschaftkeywordtag erwirtschaftet . 
Belegschaft_s15281_f0	In den ersten neun Monaten dieses Jahres wurde die bisherigekeywordtag Belegschaftkeywordtag um 2949 auf 105 525 Männer und Frauen vermindert . 
Belegschaft_s16284_f0	Gemeinschaftsfirmakeywordtag rupft Belegschaftkeywordtag 
Belegschaft_s19596_f0	Bisher gingen bis zu 90 Prozent der Belegschaftkeywordtag im Sommer drei Wochen in Urlaub . 
Belegschaft_s22246_f0	Wenn die Lohnabschlüsse eine Weile unterhalb der Produktivitätsentwicklung blieben , könnten die Firmen wieder Speck ansetzen , was auch den Wiederaufbau der Belegschaftenkeywordtag ermögliche . 
Belegschaft_s26005_f0	Im nächsten Jahr wollen die Frankfurter die Belegschaftkeywordtag in der Volksrepublik um 1000 auf 3000 Leute erhöhenkeywordtag . 
Belegschaft_s26932_f0	Ein Teil der Belegschaftkeywordtag des Spezialisten für Abfall- , Reinigungs- und Verpackungsanlagen sollte gehen . 
Belegschaft_s27315_f0	Seit der Verschmelzung der Siemens-EDV-Aktivitäten mit der Paderborner Firma Nixdorf im Oktober 1990 ist die Belegschaftkeywordtag bereits um 15 000 auf 37 200 Männer und Frauen geschrumpft . 
Belegschaft_s29966_f0	In den nächsten Wochen dürfte die Belegschaftkeywordtag außerhalb Deutschlands erstmals die inländische überholen . 
Belegschaft_s30499_f0	Tatsächlich haben die Markterschließungsstrategien der Bad Homburger im Ausland wesentlich dazu beigetragen , daß auch die inländischekeywordtag Belegschaftkeywordtag seit 1991 um immerhin 30 Prozent zugelegt hat . 
Belegschaft_s36973_f0	Die Belegschaftkeywordtag , die kräftig Einschnitte hinnehmen mußte , sinkt bis Dezember-Ultimo noch auf 3800 . 
Belegschaft_s37050_f0	Auf diesem Gebiet fahren die Dortmunder seit langem Verlust ein und reduzieren die Belegschaftkeywordtag . 
Belegschaft_s37296_f0	Auch die Belegschaftkeywordtag bekam den Konsolidierungskurs zu spüren . 
Belegschaft_s37356_f0	Ohne Übernahmen und Verkäufe wurde die Belegschaftkeywordtag verringert . 
Belegschaft_s37516_f0	Die Belegschaftkeywordtag schrumpfte zugleich um 148 auf noch rund 4200 Beschäftigte . 
Belegschaft_s37882_f0	Die Belegschaftkeywordtag wird schon des längeren stark reduziert . 
Belegschaft_s38096_f0	Als Gegenleistung erwartet die Chefetage die Zustimmung der Belegschaftkeywordtag zur 37-Stunden-Woche mit zwei unbezahlten Stunden , zur Kürzung übertariflicher Leistungen und zu mehr Samstagsarbeit . 
Belegschaft_s38175_f0	Hoechst hält Belegschaftkeywordtag und Anleger in Atem 
Belegschaft_s38185_f0	Die Belegschaftkeywordtag im Stammwerk von Hoechst , wiederholt schon mit Veränderungen konfrontiert , ist geschockt . 
Belegschaft_s38224_f0	Abgesehen von Karl Winnacker , dem Hoechst-Boß nach dem Zweiten Weltkrieg , und Erhard Bouillon , dem einstigen Arbeitsdirektor , sagt der Opponent allen Chefs ein `` neurotisches Verhältnis '' zur Belegschaftkeywordtag nach . 
Belegschaft_s38619_f0	Das dürfte nicht leicht werden , nachdem das Geldhaus in den vergangenen fünf Jahren die Belegschaftkeywordtag um fast ein Fünftel verringertkeywordtag hat . 
Belegschaft_s39078_f0	Die zusammengelegte Firma werde Anlagefonds anbieten , die Vermögen vor allem von Assekuranzen managen , Vorsorgepläne für die Belegschaftenkeywordtag aufstellen und Privatpersonen bei der Anlage ihres Geldes beraten . 
Belegschaft_s39293_f0	Bis Mitte nächsten Jahres wird die Belegschaftkeywordtag in dem badischen Werk auf 3900 Männer und Frauen aufgestockt . 
Belegschaft_s39792_f0	Die zunehmende Zahl berufstätiger Frauen veränderte das Gesicht der Belegschaftenkeywordtag . 
Belegschaft_s39940_f0	Nachdem die Belegschaftkeywordtag bis 1996 auf 3034 Leute reduziert wurde , würden `` vielleicht noch 50 '' Arbeitsplätze im Rahmen der Fluktuation eingespart . 
Belegschaft_s40012_f0	Die laufende Umstrukturierung ist allerdings mit drastischem Abbau der heimischenkeywordtag Belegschaftkeywordtag verbunden . 
Belegschaft_s40360_f0	Opel befinde sich `` auf Schleuderkurs '' , die Belegschaftkeywordtag sei von Meldungen über Qualitätsmängel , sinkende Marktanteile und Personalabbau verunsichert . 
Belegschaft_s40968_f0	Die Belegschaftkeywordtag wurde binnen zwölf Monaten um 438 auf 28 749 Leute abgebaut . 
Belegschaft_s40984_f0	Vorrangig soll der Börsengang jedoch einen Zuwachs an Image bringen , die Beteiligung der Belegschaftkeywordtag ermöglichen und neue Finanzierungsmöglichkeiten für Zukäufe , etwa durch Aktientausch , eröffnen . 
Belegschaft_s41130_f0	Er sieht Zugeständnisse der Belegschaftkeywordtag bei Urlaubs- und Weihnachtsgeld und von seiten der Arbeitgeber eine Beschäftigungsgarantie bis Oktober 1998 vor . 
Belegschaft_s41546_f0	Als angestrebte Ziele nennt Kriescher einen dickeren Gewinn und eine höhere Kapitalrendite für die Gesellschafter sowie die Möglichkeit der Ertragsbeteiligung für die Belegschaftkeywordtag . 
Belegschaft_s41659_f0	Nach den Plänen soll die Belegschaftkeywordtag bis zum Jahr 2002 auf rund 18 100 Leute reduziert werden . 
Belegschaft_s41768_f0	Management und Belegschaftkeywordtag des Unternehmens im hessischen Obertshausen haben noch immer keinen Hinweis darauf , wer der neue Eigentümer sein wird . 
Belegschaft_s41775_f0	Die durch den Verkauf der Schließsysteme an die französische Valeo um rund 1500 auf noch 3385 Köpfe reduzierte Belegschaftkeywordtag sorgte in den ersten sechs Monaten für einen Umsatz von 344 Millionen Mark . 
Belegschaft_s41846_f0	Die Belegschaftkeywordtag wurde um 624 auf 13 699 Frauen und Männer verringert . 
Belegschaft_s42015_f0	Adtranz-Statthalter Rolf Eckrodt sagte vor der Belegschaftkeywordtag , die Umstrukturierung sei die einzige Chance , um im Wettbewerb bestehen zu können . 
Belegschaft_s42152_f0	Die Belegschaftkeywordtag von einst 14 300 Leute wurde drastisch verringert . 
Belegschaft_s42216_f0	Das Tempo der Verschmelzung führe zu einer `` Zerreißprobe quer durch die Belegschaftkeywordtag '' , warnt währenddessen der zuständige Landesbezirk der Gewerkschaft Handel , Banken und Versicherungen ( HBV ) . 
Belegschaft_s42594_f0	Die Belegschaftkeywordtag möchte die Firmenleitung in etwa stabil halten . 
Belegschaft_s43155_f0	Umbau setzt die Belegschaftkeywordtag unter Druck 
Belegschaft_s43241_f0	Dann sollten sich Betriebsräte und Belegschaftkeywordtag auf jeden Fall eine gesunde Portion Mißtrauen gegenüber vollmundigen Ankündigungen und Versprechungen bewahren . 
Belegschaft_s43551_f0	Kiels Oberbürgermeister Norbert Gansel nennt den Vergleichsantrag eine `` bittere Entwicklung für die Belegschaftkeywordtag und einen schweren Schlag für das Kieler Wirtschaftsleben '' . 
Belegschaft_s43785_f0	Durch Stellenabbau , Verkauf des Fachgroßhandels und Schließung von zwei Standorten schrumpft die Belegschaftkeywordtag um rund 200 auf 900 Leute . 
Belegschaft_s44338_f0	Das teilte der vorläufige Verwalter Jobst Wellensiek der Belegschaftkeywordtag auf einer Betriebsversammlung mit . 
