benoetigen_s7342_f1	Um das zu beziffern , 	benötigt 	jedoch niemandkeywordtag Umschreibungen mit mißverständlichem Tremolo . 
benoetigen_s9459_f1	Daß die Planung von Veranstaltungen und Projekten in der Regel ein bis eineinhalb Jahre Vorlauf 	benötigt 	, ist Marianne Heuwagen klar : 
benoetigen_s12476_f1	Zahlreiche Leute würden darüber hinaus eine Behandlung des posttraumatischen Stresses 	benötigen 	, insbesondere Kinder , die während mehr als 1300 Tagen und Nächten Belagerung und Beschießung erlebten . 
benoetigen_s13974_f1	Doch die Kapitalspritze , diekeywordtag B & W 	benötigen 	würde , will und kann Kockums , die selbst eine schwere Krise hinter sich gebracht hat , nicht aufziehen . 
benoetigen_s14034_f1	Jackson Pollock seinerseits 	benötigte 	eine Zeit , ehe er von der Figur loskam und sich in jenes freie Gelände vormalte , das als Abstract expressionism zunächst berüchtigt , später berühmt werden sollte . 
benoetigen_s15775_f1	`` Für die Fahrt von A nach B darf mankeywordtag kein Buch der tausend Regeln 	benötigen 	. '' 
benoetigen_s16994_f1	Schließlich wird in einer Zeit , in der der eidgenössische Tourismus in seiner tiefsten Krise steckt , jeder Gast 	benötigt 	. 
benoetigen_s17144_f1	Ab der elften Woche ist aus dem Embryo ein Fötus geworden , derkeywordtag nach weiteren drei Wochen seine Entwicklung praktisch schon abgeschlossen hat und die Restzeit der Schwangerschaft dafür 	benötigt 	, zu wachsen und für das Leben nach der Geburt zu trainieren . 
benoetigen_s19251_f1	Mehr Zeit als bisher geplant dürfte der Parteitag auch 	benötigen 	, um über die Wirtschafts- , Beschäftigungs- und Umweltpolitik zu beraten . 
benoetigen_s19543_f1	Die alarmierten Löschzüge aus der Region 	benötigten 	drei Stunden , um den Brand unter Kontrolle zu bekommen . 
benoetigen_s19867_f2	Als Arbeitsplatzwunder , daskeywordtag nicht nur in Deutschland , sondern europaweit dringend 	benötigt 	wird , gelten dagegen die kleinen und mittleren Unternehmen . 
benoetigen_s21756_f1	Einen langen Atem 	benötigen 	jedoch alle Anbieter . 
benoetigen_s21829_f2	Die Weiden , darunter Bruch- , Kork- , Mandel- oder Purpurweiden , 	benötigen 	zur Entwicklung Überflutungen von 30 bis 50 Tagen . 
benoetigen_s21935_f1	So verbraucht der Erndtebrücker Kindergarten nur ein Fünftel der Energie , diekeywordtag gleichgroße Gebäude normalerweise für Heizung und Strom 	benötigen 	. 
benoetigen_s21949_f1	`` Die Einrichtungen der evangelischen Kirche 	benötigen 	Wärme und Energie in der Größenordnung einer Stadt wie Hannover '' , sagt Uwe Ilgemann vom Öko-Institut Freiburg . 
benoetigen_s23997_f1	Andererseits 	benötigt 	das dichtbesiedelte Europa geringerekeywordtag Investitionenkeywordtag zur Anbindung entlegener Regionen . 
benoetigen_s24112_f2	Partizipationkeywordtag 	benötigt 	weniger die Technik , als den politischen Willen . 
benoetigen_s27775_f1	`` Wehrpflicht glaubwürdig zu erhalten , heißt also zu erklären , weshalb wirkeywordtag siekeywordtag trotz des Wegfalls der unmittelbaren äußeren Bedrohung immer noch 	benötigen 	'' , sagte der Bundespräsident . 
benoetigen_s28751_f1	Es wird verstehbar , weshalb das Ökozentrum Werratal so wenig Leute 	benötigt 	- oder allgemeiner , was die großen ostdeutschen Güter den bäuerlichen Familienbetrieben an Produktivität voraushaben . 
benoetigen_s29352_f1	Kündige ein Angestellter selbst , verliere der Arbeitgeber unter Umständen einen Mitarbeiter , denkeywordtag erkeywordtag für eine `` geordnete Durchführung der Betriebsänderung '' noch 	benötige 	, sagten die Richter . 
benoetigen_s29402_f1	Es ist aufschlußreich für den Maßstab , den Deng an Produktivität anlegt , wenn er die ökonomische Binsenweisheit , daß die Arbeitskraft mehr zu produzieren in der Lage ist als siekeywordtag zu ihrer eigenen Reproduktion 	benötigt 	, in ihr Gegenteil umkehrt : 
benoetigen_s29786_f1	Von diesem Metall 	benötigte 	die Elektroindustrie weltweit mit 82 Tonnen knapp ein Fünftel mehr . 
benoetigen_s32946_f1	Wie viele Ökonomen geht auch der Pekinger Abteilungsleiter Zhang Shouqi davon aus , daß diese Firmen bis zu einem Drittel mehrkeywordtag Leutekeywordtag haben als siekeywordtag eigentlich 	benötigen 	. 
benoetigen_s34790_f1	wo die Weltwirtschaft zum Schicksal geworden ist , 	benötigt 	mankeywordtag im Grunde nur noch effiziente Technokraten . 
benoetigen_s36584_f1	Malaysias Ministerpräsident Mahathir Mohamad bekräftigte , die Staaten der Gemeinschaft 	benötigten 	Unterstützung , die über die vom Internationalen Währungsfonds ( IWF ) beschlossenen Leistungen hinausgehe . 
benoetigen_s39002_f1	Daß die Kommunen die Gewinne ihrer Stadtwerke mit Verve verteidigen , weil siekeywordtag diesekeywordtag zur Subventionierung defizitärer Leistungen wie zum Beispiel Nahverkehr oder Müllabfuhr 	benötigen 	, kann Farnung zwar verstehen , läßt ihn aber nicht von seiner Position abrücken , daß Wettbewerb nun mal unteilbar ist . 
