beobachten_s3026_f2	Dort griff die Polizei unter Gewaltanwendung einzelne Demonstranten heraus , wobei Tritte und Schläge mit dem Knüppel von Polizisten 	beobachtet 	wurden . 
beobachten_s3395_f1	Erkeywordtag habe von der Polizei einekeywordtag Härtekeywordtag 	beobachtet 	, `` die an Brutalität grenzte '' . 
beobachten_s4726_f2	Am besten ist dieskeywordtag in der Kirche von San Juan Chamula zu beobachten , alleiniges Zentrum für mehr als 75 000 Gläubige . 
beobachten_s7345_f2	Wo Veränderungen in der Substanz zu beobachten sind - von erodierenden Parteien bis zur schleichenden Preisgabe repräsentativer Strukturen - , wäre es schon sehr problematisch , dies als direkte Folge des Zustandes der Bonner oder Berliner Republik auszuschellen . 
beobachten_s8783_f0	In dem Bericht soll vor allem auch die Frage angesprochen werden , ob die militante jüdische Rechtsszene ausreichend von Agenten 	beobachtet 	wurde . 
beobachten_s9499_f0	Beim Menschen konnte Mertelsmannkeywordtag bisher aber 	beobachten 	, daß die Killerzellen nur bei den Hautkrebspatienten die Tumorzellen einkreisen und vernichten , und dies auch nur in unmittelbarer Nähe der Einspritzstelle . 
beobachten_s10325_f1	Eskeywordtag 	beobachte 	von Ferne und werde seine Meinung äußern . 
beobachten_s11402_f1	Verschiedene Erscheinungen dieser Form des Postkommunismus , ob schon ausdrückliche oder eher unauffällige , können wirkeywordtag nämlich auch in unseren Ländern 	beobachten 	. 
beobachten_s11452_f1	Das Anwachsen des Nationalismus , der Xenophobie , des Rassismus , des Antisemitismus und ähnlicher gefährlicher Erscheinungen , diekeywordtag wirkeywordtag - in einem größeren oder kleineren Maße - in all den Ländern 	beobachten 	können , die sich vom Kommunismus losgesagt haben , hat offensichtlich seine Ursache eben in den Umständen , die ich hier erwähnte . 
beobachten_s11871_f2	Schon jetzt sei eine Zunahme gentechnologischer Freisetzungen in Entwicklungsländern zu beobachten . 
beobachten_s15668_f1	In deutschen diplomatischen Kreisen 	beobachtet 	mankeywordtag besorgt , daß Washington inzwischen dazu neigt , den Islam insgesamt zu verteufeln . 
beobachten_s16006_f1	Wie ein UN-Vertreter in der Nacht zum Freitag in Zagreb sagte , wurden Truppenbewegungenkeywordtag in den Gebieten Vinkovici und Nustar 	beobachtet 	. 
beobachten_s16008_f1	Auch auf serbischer Seite wurden Truppenbewegungenkeywordtag 	beobachtet 	. 
beobachten_s16319_f1	Auch auf serbischer Seite seien Truppenbewegungenkeywordtag 	beobachtet 	worden . 
beobachten_s16418_f2	Diese Dispersion läßt sich sowohl in der Ästhetik wie auch in der Produktions- und Vertriebsweise der Filme 	beobachten 	. 
beobachten_s17356_f0	Ichkeywordtag döste bis zum späten Nachmittag im Schatten einer Garküche vor mich hin , 	beobachtete 	das Spiel der Wolken über dem arabischen Meer , sah einsame Kamele scheinbar ziellos über den Strand laufen , verfolgte den Andrang der Strandbesucher , die in einem Ebbe und Flut vergleichbaren Rhythmus den Bussen entstiegen , durch Gebüsch und Geröll zum Meeresufer eilten um sich dort eine Weile in die rätselhafte Gruppe der Fußbadenden einzureihen , ehe sie wieder zu den Bussen in Richtung Innenstadt verschwanden . 
beobachten_s17368_f0	Ichkeywordtag blieb bis nach Sonnenuntergang am Mausoleum , 	beobachtete 	die langen Schatten der jungen Soldaten bei der Wachablösung und sah in der Ferne , wie sich der immer grauer werdende urbane Steinteppich , der den gesamten Horizont bedeckte , in ein fluoriszierendes Lichtermeer verwandelte . 
beobachten_s17682_f2	Während bis vor etwa 20 Jahren sich die `` Internationalisierung '' der Wirtschaft im wesentlichen auf den Gütermärkten abspielte , ist in den letzten Jahren eine verstärkte Entgrenzung auch der Faktormärkte , das heißt der Finanzmärkte , Technologiemärkte und Arbeitsmärkte zu beobachten . 
beobachten_s17905_f0	Hier haben die Filmemacher eine eigene Filmsprache entwickelt , den Atem angehalten und 	beobachtet 	, wie eine Kobra sich langsam über Wüstensand bewegt . 
beobachten_s18653_f1	Vom Fernsehen live übertragen , 	beobachtet 	das an Korruption nun wahrlich nicht ungewohnte Volk mit einer seltsamen Mischung aus Faszination und Abscheu , wie stark der Filz zwischen den Spitzen der Politik und der Wirtschaft ist . 
beobachten_s19209_f0	Mit wachsendem Unbehagen 	beobachtet 	nämlich die Union das Gebaren der Liberalen , die sich neuerdings auffällig häufig mit dem Koalitionspartner fetzen . 
beobachten_s20123_f0	Ein Braunschweiger Biologe 	beobachtete 	Deutsche am Steuer 
beobachten_s20126_f0	Dies meint jedenfalls der Braunschweiger Biologe Professor Georg Rüppell , derkeywordtag seit über 15 Jahren das Verhalten von Autofahrern 	beobachtet 	. 
beobachten_s20398_f1	Schon jetzt lasse sich Diskriminierung unter den Ausländern 	beobachten 	: 
beobachten_s22635_f0	66 Europäer sowie zehn US-Amerikaner sind bereits eingetroffen , um die Wahlregistrierung zu beobachten . 
beobachten_s24031_f2	Dienstleistungen nehmen zwar noch zu , aber auch hier gibt es Probleme , diekeywordtag auf zwei Feldern zu beobachten sind : Die herkömmlichen Dienstleistungen und die neuen , sogenannten Informationsdienstleistungen . 
beobachten_s24098_f2	Doch ist hier Neueskeywordtag zu beobachten . 
beobachten_s24433_f2	Das Phänomen , das zum ersten Mal in den 60er Jahren auftrat , wird seit einiger Zeit am Korallenriff zwischen Mexiko und Jamaika sowie den Bahamas 	beobachtet 	, das zur Touristenattraktion der Karibik und den besten Tauchgründen weltweit zählt . 
beobachten_s24442_f2	So wurde bereits 1979 und 1980 eine Verbreitung der Krankheit in den Keys von Florida , den Bahamas ebenso wie im östlichen Pazifik in einer Tiefe von 70 Meter 	beobachtet 	. 
beobachten_s24851_f2	Mit Mißtrauen 	beobachten 	siekeywordtag Japans Bestreben , in Asien wieder die Führungsrolle zu übernehmen . 
beobachten_s29221_f1	Mankeywordtag 	beobachtet 	ja auch anderswo Aufbrüche dieser Art , Klaus Pohl zum Beispiel dramatisiert seine Spiegel-Interviews ( Wartesaal Deutschland , uraufgeführt am Deutschen Theater in Berlin ) . 
beobachten_s29293_f1	Ichkeywordtag habe früher oft an älterwerdenden Regiekollegen 	beobachtet 	, wie ihre Wahrnehmung sich trübte . 
beobachten_s31581_f0	Mit Sorge 	beobachtete 	siekeywordtag das Vordringen von denaturierten Lebensmitteln in ein Tal , in dem fast alles noch am Ort erzeugt wird oder wie einst wieder produziert werden könnte . 
