beschleunigen_s1108_f1	Andererseits sei die Unterstützung der Wirtschaft nur sinnvoll , wenn siekeywordtag den russischen Reformprozeß 	beschleunige 	. 
beschleunigen_s1288_f1	Richter : Das neue Asylgesetz 	beschleunigt 	Verfahrenkeywordtag nicht 
beschleunigen_s1290_f1	Das neue Asylverfahrensgesetz wird die meisten Klagen auf Asyl nach Meinung des Präsidenten des größten deutschen Asylzentralgerichts in Ansbach , Lothar Schmitt , nicht wesentlich 	beschleunigen 	. 
beschleunigen_s3262_f1	Das sei möglich , wenn - kurzfristig Ausrüstungslieferungen erhöht , Fachpersonal bereitgestellt und Know-how transferiert sowie - mittel- und langfristig die Exploration und Entwicklung von Öl- und Gasfeldern 	beschleunigt 	würden . 
beschleunigen_s3266_f1	Außerdem mahnt der Entwurf für die G-7-Initiative an , die Stabilität und Konvertibilität des Rubels sicherzustellen , die staatlichen Dirigismen abzubauen und die Privatisierung zu beschleunigen . 
beschleunigen_s5176_f1	Deshalb fordern wir von der Bundesregierung eine aufkommensneutrale ökologische Steuerreform , diekeywordtag technische Innovation und Effizienzsteigerung 	beschleunigt 	. 
beschleunigen_s5214_f1	Daskeywordtag würde außerdem die Aufwertung nur 	beschleunigen 	. 
beschleunigen_s5631_f1	Pereskeywordtag könnte nun versucht sein , vor dem beginnenden israelischen Wahlkampf das Friedenstempo zu beschleunigen . 
beschleunigen_s6890_f1	Und je mehr sich die Rate der Naturausbeute 	beschleunigt 	, desto schneller macht sich die Endlichkeit der Natur schon heute bemerkbar ; 
beschleunigen_s12149_f1	Mit Sorge sieht er dabei Bemühungen der Deutsche Börse AG , diekeywordtag ihm vor allem die Einrichtung einer elektronischen Börse für alle deutschen Aktien zu beschleunigen scheinen . 
beschleunigen_s12819_f1	Unicefkeywordtag versuche daher , die Prozeßvorbereitungen für die Kinder zu beschleunigen , denen Beteiligung am Völkermord vorgeworfen wird . 
beschleunigen_s13102_f1	Syrienkeywordtag will Gespräche über Frieden `` 	beschleunigen 	'' 
beschleunigen_s13104_f1	Die syrische Regierung will die Verhandlungen über einen Frieden im Nahen Osten `` 	beschleunigen 	'' . 
beschleunigen_s14892_f1	Seit Mitte der 70er Jahre 	beschleunigt 	sich jedoch die Reintegration der Weltmärkte für Kapital , Waren und Dienstleistungen . 
beschleunigen_s18058_f1	Seit Mitte der 70er Jahre 	beschleunigt 	sich jedoch die Reintegration der Weltmärkte für Kapital , Waren und Dienstleistungen . 
beschleunigen_s19107_f1	Hierzu gehöre es , die Grenzen stärker als bisher zu sichern , die laufenden Verfahren zu beschleunigen und die abgelehnten Bewerber schneller abzuschieben . 
beschleunigen_s24961_f1	Dieser Trend werde sich noch 	beschleunigen 	, warnt Küchler . 
beschleunigen_s25109_f1	Die Regierungen könnten aber jederzeit entweder die `` Globalisierung '' des Warenaustausches 	beschleunigen 	oder den Prozeß umkehren . 
beschleunigen_s30357_f1	750 Leute wechseln zu dem Serviceanbieter , derkeywordtag in Derby ein Zentrum schafft , um den `` Wandlungsprozeß '' der Triebwerk-Gruppe zu beschleunigen . 
beschleunigen_s35623_f1	Japankeywordtag will Liberalisierungkeywordtag 	beschleunigen 	/ 
