Beschaeftigter_s33_f1	Von seinenkeywordtag Beschäftigtenkeywordtag verlange er vor allem Arbeitsmoral und ordentliches Auftreten . 
Beschaeftigter_s225_f1	Selbst der Hauptverband des Deutschen Einzelhandels ( HDE ) gibt `` Einzelfälle '' zu , in denen Beschäftigtekeywordtag `` ausrasten und ihre Kompetenzen überschreiten '' . 
Beschaeftigter_s235_f1	Die Schadensbilanz nämlich fußt auf `` Inventurdifferenzen '' , die zwischen dem Kundenklau , dem Beiseiteschaffen durch die Beschäftigtenkeywordtag und schließlich schnöden Rechenfehlern keinen Unterschied machen . 
Beschaeftigter_s581_f1	Fast eine halbe Million Stellen ist verlorengegangen , die Hälfte der noch 300 000 Beschäftigtenkeywordtag arbeitet kurz . 
Beschaeftigter_s732_f1	Manager und Beschäftigtekeywordtag müßten an Privatisierungen beteiligt werden , um ihre Motivation zu heben . 
Beschaeftigter_s1035_f1	Zwickel wies darauf hin , daß nach einer Änderung des Gesetzes über die Lohnfortzahlung die entsprechenden tarifvertraglichen Regelungen nur noch für 50 Prozent der Beschäftigtenkeywordtag gelten würden . 
Beschaeftigter_s1244_f1	Die Beschäftigtenkeywordtag sollen der Zeitung zufolge heute auf einer Betriebsversammlung vom Vorstand über Einzelheiten unterrichtet werden . 
Beschaeftigter_s1579_f1	Niedersachsen bemüht sich um ein Halbleiter-Werkkeywordtag mitkeywordtag etwa 1000 Beschäftigtenkeywordtag , das der südkoreanische Konzern Samsung hierzulande bauen will . 
Beschaeftigter_s1921_f1	Die Ankündigung von Bundeswirtschaftsminister Jürgen Möllemann ( FDP ) , er wolle die Möglichkeit zur untertariflichen Bezahlung von Beschäftigtenkeywordtag schaffen , hat in den fünf neuen Ländern bereits zu Nachteilen für Arbeitnehmer geführt . 
Beschaeftigter_s2279_f1	Da die Beschäftigtenkeywordtag Schutzmasken getragen hätten , sei kein Schaden entstanden . 
Beschaeftigter_s2992_f1	Nur durch die erstmalige Einbeziehung der Töchter in der Ex-DDR , die mit noch 18 000 Beschäftigtenkeywordtag im laufenden Geschäftsjahr sechs Milliarden Orders und vier Milliarden Umsatz ( davon 80 Prozent mit öffentlichen Kunden ) hereinholen sollen , wuchs die Belegschaft in den ersten acht Monaten um 13 000 auf weltweit 415 000 Männer und Frauen . 
Beschaeftigter_s3100_f1	Die Zahl der Beschäftigtenkeywordtag kletterte innerhalb von zwölf Monaten um 900 auf 4888 Ende Dezember . 
Beschaeftigter_s3180_f1	Der DPG-Vorstand erhofft sich dann auch Klarheit über die komplette Strategie bei derkeywordtag gelbenkeywordtag Postkeywordtag mitkeywordtag ihrenkeywordtag derzeit 310 000 Beschäftigtenkeywordtag in den alten Ländern . 
Beschaeftigter_s3246_f1	Im Mittelpunkt sollen der Austausch von Beschäftigtenkeywordtag , die Entsendung von Managern zur Beratung von Betrieben im Übergang zur Marktwirtschaft und die Einrichtung von Ausbildungsstipendien stehen . 
Beschaeftigter_s3276_f1	Nach Firmenangaben ignorierten die Beschäftigtenkeywordtag ein Ultimatum zur Wiederaufnahme der Arbeit . 
Beschaeftigter_s3811_f1	Die Arbeitsniederlegungen , an denen -- -- NGG-Angaben 500 bis 800 Beschäftigtekeywordtag beteiligten , waren am Dienstag zunächst ausgeweitet worden . 
Beschaeftigter_s3812_f1	Die Beschäftigtenkeywordtag kritisierten , daß die Arbeitgeber sich bisher geweigert hätten , einen Tarifvertrag für das gesamte Bundesland abzuschließen . 
Beschaeftigter_s4400_f1	Dadurch wolle man erreichen , daß mindestens die Hälfte dieser Beschäftigtenkeywordtag `` in anständige Teilzeitarbeit '' übernommen werden müsse . 
Beschaeftigter_s6477_f1	Die Telekom hatte ihr Abbauziel zuletzt auf 60 000 Beschäftigtekeywordtag bis zum Jahr 2000 hochgeschraubt . 
Beschaeftigter_s7669_f1	Das Milchwerk in Elsterwerda setzte im Geschäftsjahr per Ende September mit 190 Beschäftigtenkeywordtag rund 230 Millionen Mark um . 
Beschaeftigter_s7943_f1	Bötsch möchte hingegen nach der für Ende 1997 geplanten Auflösung deskeywordtag Postministeriumskeywordtag mitkeywordtag derzeit 400 Beschäftigtenkeywordtag eine eigene Schiedsrichterstelle schaffen , bei der etwa 200 Leute arbeiten sollen . 
Beschaeftigter_s7989_f1	Er befürchtet nämlich , daß eine solche Rentenkürzung - rund elf Prozent im Vergleich zu einem Ruhestand mit 63 Jahren - bei künftigen Sozialplan-Verhandlungen für älterekeywordtag Beschäftigtekeywordtag über Ausgleichsforderungen auf die Betriebe zurückschlagen werde . 
Beschaeftigter_s8053_f1	Durch individuelle Zeitkonten für die Jahres- und Lebensarbeitszeit seien den betrieblichen Anforderungen und den sozialen Interessen der Beschäftigtenkeywordtag Rechnung zu tragen . 
Beschaeftigter_s8195_f1	Trotz guter Tarifabschlüsse hätten die Beschäftigtenkeywordtag immer weniger Geld . 
Beschaeftigter_s8221_f1	Mit niedrigeren Lohnnebenkosten will er zwei Fliegen mit einer Klappe schlagen : Entlastung vor allem kleinerer Unternehmen und des Mittelstands sowie Erleichterungen für die Beschäftigtenkeywordtag . 
Beschaeftigter_s8285_f1	Die Zahl der Beschäftigtenkeywordtag hat sich im Konzern binnen Jahresfrist bereinigt um 7497 und in der AG um 3773 oder acht Prozent verringert . 
Beschaeftigter_s8582_f1	Nun haben die Beschäftigtenkeywordtag in Baden-Württemberg , Rheinland-Pfalz , Thüringen , Bayern und Sachsen-Anhalt nur Anspruch auf ganztägige unbezahlte Freistellung . 
Beschaeftigter_s8587_f1	So lagen etwa demkeywordtag Maschinenbauunternehmenkeywordtag Phoenixkeywordtag bei Detmold , mitkeywordtag 2500 Beschäftigtenkeywordtag einer der größten Arbeitgeber in Lippe , zunächst noch keine Anträge auf Freistellung vor . 
Beschaeftigter_s9724_f1	Am Main gibt es mittlerweile 135keywordtag Auslandsbankenkeywordtag mitkeywordtag 11 000 Beschäftigtenkeywordtag . 
Beschaeftigter_s9803_f1	Die Schwaben erwarten 1995 etwa 190 Millionen Mark Umsatz , für den rund 1000 Beschäftigtekeywordtag hierzulande sowie in Rumänien und China sorgen . 
Beschaeftigter_s9911_f1	Zuletzt war die Zahl der Beschäftigtenkeywordtag noch um 494 auf 56 503 verringert worden . 
Beschaeftigter_s9965_f1	Vom Gewinnwachstum sollen zwar die Aktionäre profitieren , nicht aber die Beschäftigtenkeywordtag . 
Beschaeftigter_s10060_f1	Für Bund , Länder und Gemeinden , für die Wirtschaft und die ( noch ) Beschäftigtenkeywordtag , für Europa . 
Beschaeftigter_s10075_f1	Die Subventionen für den deutschen Steinkohlenbergbau belaufen sich in diesem Jahr auf mehr als 100 000 Mark pro Beschäftigtenkeywordtag ; 
Beschaeftigter_s10241_f1	Es sei ein `` Skandal '' , sagte Scharping , daß die Arbeitslosigkeit auf dem Bau steige und inzwischen 150 000 deutsche Bauarbeiter arbeitslos seien , während gleichzeitig Beschäftigtekeywordtag aus anderen Ländern auf Baustellen ausgebeutet würden . 
Beschaeftigter_s11973_f1	Wer auch das noch verkaufen wolle , bewirke `` Unruhe bei Beschäftigtenkeywordtag und Mietern '' , werde die erhofften Einnahmen aber nicht erzielen . 
Beschaeftigter_s12240_f1	Die Staatsanwaltschaft Frankfurt ermittelt gegen einen Beschäftigtenkeywordtag der Dresdner Bank wegen des Verdachts auf verbotenen Insiderhandel . 
Beschaeftigter_s12257_f1	Dazu wird ein Joint-venturekeywordtag mitkeywordtag 190 Beschäftigtenkeywordtag gegründet . 
Beschaeftigter_s12693_f1	die Pfarrer müßten also Beschäftigtekeywordtag der Kirchen bleiben . 
Beschaeftigter_s12767_f1	So bleibt es nationalen Regelungen vorbehalten , wie sie sicherstellen , daß ein Beschäftigterkeywordtag nach dem Sonderurlaub auf die alte oder eine gleichwertige Stelle zurückkehren kann , und welche Möglichkeiten es geben wird , die Auszeit in Etappen oder halbtags zu nehmen . 
Beschaeftigter_s12768_f1	Überdies sollen die Firmen das Recht haben , die Abwesenheit eines Beschäftigtenkeywordtag zu verschieben , wenn die Betriebssituation dies erforderlich macht . 
Beschaeftigter_s13605_f1	Ob die 142 Beschäftigtenkeywordtag entlassen würden , sei noch unklar . 
Beschaeftigter_s13960_f1	1100 Beschäftigtekeywordtag verlieren ihren Arbeitsplatz 
Beschaeftigter_s13978_f1	Auch bei Danyardkeywordtag mitkeywordtag 2000 Beschäftigtenkeywordtag soll 1997 mit dem Schiffbau Schluß sein . 
Beschaeftigter_s13991_f1	Auch jetzt erinnerten sich die Beschäftigtenkeywordtag ihrer Traditionen . 
Beschaeftigter_s13993_f1	Doch dabei ging es nicht mehr um eine Rettung des Unternehmens , sondern nur noch um ausreichende Abfindungen für die um ihre Jobs gebrachten Beschäftigtenkeywordtag . 
Beschaeftigter_s14188_f1	Mit rund 2200 Beschäftigtenkeywordtag wurden in den ersten neun Monaten die Erlöse um 13 Prozent auf 571 Millionen Mark gesteigert . 
Beschaeftigter_s14873_f1	Wieviele der 12 900 Beschäftigtenkeywordtag gehen müssen , wird nicht verraten . 
Beschaeftigter_s14933_f1	Es beziffert die Beschäftigtenkeywordtag im Umweltsektor auf 680 000 und hält eine Steigerung auf 1,1 Millionen bis 2000 für möglich . 
Beschaeftigter_s15395_f1	wegen der `` Gewalt , die unserekeywordtag Beschäftigtenkeywordtag dort unten erfahren mußten '' , wie es ein Shell-Sprecher der FR erklärte . 
Beschaeftigter_s15522_f1	Der Nachfolger des aus Altersgründen nicht mehr zur Kandidatur angetretenen DBB-Vorsitzenden Werner Hagedorn will den Beamtenbund `` zu einer Art Dienstleistungsgewerkschaft '' machen , die sich auch für die Beschäftigtenkeywordtag außerhalb des öffentlichen Dienstes öffnen solle . 
Beschaeftigter_s15953_f1	Vor allem die von Zwickel geforderte Einstellung von 100 000 zusätzlichen Beschäftigtenkeywordtag bereits 1996 sei `` nicht nur unrealistisch , sondern schlicht unmöglich '' . 
Beschaeftigter_s16348_f1	Die rund 50 000 Beschäftigtenkeywordtag der ostdeutschen Sparkassen erhalten mit Wirkung vom 1. Oktober an 86,5 Prozent der westdeutschen Gehälter . 
Beschaeftigter_s16351_f1	Bislang hätten die Beschäftigtenkeywordtag der ostdeutschen Sparkassen 84 Prozent des Westgehaltes erhalten . 
Beschaeftigter_s17702_f1	Diese explizite Berücksichtigung der Arbeitnehmerinteressen ( auch ) bei der Arbeitszeitgestaltung ist insofern erforderlich , als auf die Beschäftigtenkeywordtag der nächsten Jahre Mobilitäts- und Flexibilisieriungserfordernisse von bisher nicht gekanntem Ausmaß zukommen werden . 
Beschaeftigter_s17786_f1	Angestellte stellen heute mit rund 52 Prozent die Mehrheit der abhängigkeywordtag Beschäftigtenkeywordtag , aber 40 Prozent von ihnen präferieren die CDU und zehn Prozent die Grünen . 
Beschaeftigter_s17835_f1	Hier hat sich die Zahl der Beschäftigtenkeywordtag zwischen 1960 und 1993 verdoppelt bis verdreifacht . 
Beschaeftigter_s18099_f1	Es beziffert die Beschäftigtenkeywordtag im Umweltsektor auf 680 000 und hält eine Steigerung auf 1,1 Millionen bis 2000 für möglich . 
Beschaeftigter_s18867_f1	Bei den Wiesbadenern verdienen den Angaben zufolge etwa 180 Festangestellte sowie eine große Zahl geringfügigkeywordtag Beschäftigterkeywordtag ihr Geld . 
Beschaeftigter_s19052_f1	Geplant ist die Errichtung eines Werks mit einer Kapazität von 440 000 Jahrestonnen und 1000 Beschäftigtenkeywordtag . 
Beschaeftigter_s19056_f1	Die Gesellschaft setzte zuletzt mit 296 Beschäftigtenkeywordtag 54 Millionen Mark um . 
Beschaeftigter_s19584_f1	Volkswagen streicht möglicherweise die Werksferien für die mehr als 100 000 Beschäftigtenkeywordtag in der Bundesrepublik . 
Beschaeftigter_s19870_f1	Allein in Westdeutschland existieren 3,1 Millionen Unternehmenkeywordtag mitkeywordtag weniger als 20 Beschäftigtenkeywordtag . 
Beschaeftigter_s19882_f1	Diese Therapie bürdet den Beschäftigtenkeywordtag höhere Steuern auf und schwächt somit den Anreiz , zu arbeiten . 
Beschaeftigter_s19893_f1	Gerade die deutschen Konzerne prägen noch die autoritäre Einstellung des Arbeitgebers `` gegen seinekeywordtag abhängigkeywordtag Beschäftigtenkeywordtag '' , ein hierarchisches Denken , das Eigeninitiative und Selbstbestimmung der mitarbeitenden Menschen unterbindet . 
Beschaeftigter_s21269_f1	Ende September hattekeywordtag Scheringkeywordtag weltweitkeywordtag 18 217 Beschäftigtekeywordtag - 405 weniger als vor Jahresfrist . 
Beschaeftigter_s21971_f1	Dazu hat das Öko-Institut nach Gesprächen mit Fachleuten aus der kirchlichen Bau- und Finanzverwaltung , den Umweltbeauftragten der EKD und der Landeskirchen sowie engagierten Einzelpersonen fünf Bausteine entwickelt : Mindeststandards für den Energieverbrauch und die eingesetzte Technik , regelmäßige Kontrollen , verstärkte Informationsarbeit , Weiterbildung für die Beschäftigtenkeywordtag und eine bessere Öffentlichkeitsarbeit mittels Musterbeispielen . 
Beschaeftigter_s22529_f1	Am meisten gefährdet und besonders stark betroffen sind ausländische Arbeitnehmer , Neueingestellte , Beschäftigtekeywordtag über 45 Jahre , Leiharbeiter und Jugendliche . 
Beschaeftigter_s22531_f1	Über diese sollten sich die Beschäftigtenkeywordtag selbst , vor allem aber die Arbeitgeber und die Betriebs- beziehungsweise Personalräte informieren . 
Beschaeftigter_s22534_f1	Unternehmen müssen über Gefahren und Unfälle Buch führen , die Beschäftigtenkeywordtag über Risiken unterrichten , angemessen unterweisen und eine regelmäßige arbeitsmedizinische Überwachung gewährleisten . 
Beschaeftigter_s23425_f1	Betroffen vom Ausstand ist fast die Hälfte der 1,9 Millionen zivilenkeywordtag Beschäftigtenkeywordtag des Bundes . 
Beschaeftigter_s23428_f1	In den vergangenen 14 Jahren mußte die Regierung achtmal Pause machen , in drei Fällen mußten Beschäftigtekeywordtag zu Hause bleiben . 
Beschaeftigter_s23864_f1	Der ABS-Zweig des US-Konzerns setzt mit 1400 Beschäftigtenkeywordtag rund 700 Millionen Dollar um . 
Beschaeftigter_s24044_f1	Tarifverträge , Gesundheitsschutz , ArbeitnehmerInnen-Organisation verflüchtigen sich auf einem global vernetzten Arbeitsmarkt , dem die Beschäftigtenkeywordtag nichts Gleichwertiges entgegenzusetzen haben . 
Beschaeftigter_s24052_f2	Ihr Fazit ist : Arbeit für die Masse der Bevölkerung wird es nicht mehr geben , Arbeit wird von immer mehr temporärkeywordtag Beschäftigtenkeywordtag geleistet , die Schere zwischen qualifizierter und unqualifizierter Arbeit weitet sich , weite Teile der Beschäftigtenkeywordtag werden marginalisiert . 
Beschaeftigter_s24254_f1	`` Empörung '' und `` Unverständnis '' herrscht unter den Beschäftigtenkeywordtag des Deutschen Gewerkschaftsbundes ( DGB ) über den eigenen Arbeitgeber . 
Beschaeftigter_s24265_f1	Diese hatten ihrenkeywordtag Beschäftigtenkeywordtag trotz Sparmaßnahmen lineare Erhöhungen zugestanden . 
Beschaeftigter_s24490_f1	Der Hoechst-Chef ( Foto : Wolfgang von Brauchitsch ) habe begriffen , `` daß er den selbstzufriedenen Konzern nur aufbrechen kann , wenn die Führungskräfte anders mit den Beschäftigtenkeywordtag und der Öffentlichkeit reden '' , lobt Wolfgang Kaden , Chefredakteur des Manager Magazin , das den Preis vergibt , den 55jährigen . 
Beschaeftigter_s24537_f1	Alskeywordtag 	Beschäftigte 	bei exportorientierten Unternehmen dürften aber auch Privatpersonen das Ende der Kursschwankungen schon drei Jahre früher schätzen lernen . 
Beschaeftigter_s24957_f1	Sie befürchtet eine allgemeine Senkung des Lohnniveaus , zumal eine neue niedrigere Tarifgruppe nicht nur für Beschäftigtekeywordtag ausländischer Firmen auf den Baustellen , sondern auch für die deutscher Unternehmen gelten würde . 
Beschaeftigter_s24959_f1	Mit 770 000 gewerblichkeywordtag Beschäftigtenkeywordtag werde der Stand des Jahres 1990 dann unterschritten . 
Beschaeftigter_s25272_f1	Es gehe ihm vor allem darum , den um ihre Arbeitsplätze bangenden Beschäftigtenkeywordtag zu helfen . 
Beschaeftigter_s26000_f1	Seinenkeywordtag 65 000 Beschäftigtenkeywordtag zahlt Karstadt das Weihnachtsgeld in Form von Warengutscheinen aus . 
Beschaeftigter_s26933_f1	Doch dann wagten sich die Beschäftigtenkeywordtag wie einst Columbus und seine Mannschaft ins Ungewisse . 
Beschaeftigter_s26938_f1	Gesucht waren mittelständische Unternehmen , die seit 1990 neue Stellen einrichten , vorhandene langfristig sichern oder die Leistungsfähigkeit der Beschäftigtenkeywordtag nachhaltig steigern konnten . 
Beschaeftigter_s27318_f1	337 000 Mark ( plus 18 Prozent ) setzte SNI zuletzt pro Beschäftigtenkeywordtag um . 
Beschaeftigter_s27347_f1	Statt die Wochenarbeit zu verringern , sollten die von der Kirche Beschäftigtenkeywordtag nach sechs Jahren Arbeit ein Sabbatjahr einlegen können . 
Beschaeftigter_s27664_f1	Der Arbeitszeit-Rhythmus in den Betrieben , hielt er Schleef entgegen , dürfe `` nicht nur durch Aufträge '' , sondern müsse auch durch die Wünsche der Beschäftigtenkeywordtag bestimmt werden . 
Beschaeftigter_s27666_f1	Wer bestimmt darüber , wann und wie der flexible Einsatz der Beschäftigtenkeywordtag im Betrieb laufen soll ? 
Beschaeftigter_s27841_f1	Der Kampf gegen spätere Ladenschlußzeiten vereint Beschäftigtekeywordtag und mittelständische Händler 
Beschaeftigter_s27865_f1	Bei den Beschäftigtenkeywordtag herrsche `` helle Empörung '' , sagt Schüssler . 
Beschaeftigter_s27875_f1	Die HBV will in ihrer Kampagne deshalb nicht die Nachteile für die schätzungsweise 2,5 Millionen abhängigkeywordtag Beschäftigtenkeywordtag herausstreichen , sondern die negativen Folgen für den unternehmerischen Mittelstand . 
Beschaeftigter_s27880_f1	`` Der Zuwachs von insgesamt 23 000 Beschäftigtenkeywordtag bei Warenhäusern , Verbrauchermärkten und SB-Warenhäusern sowie Fachmärkten wird überkompensiert durch Arbeitsplatzverluste im Fachhandel '' , schreiben die IMU-Experten . 
Beschaeftigter_s28583_f1	Mehr als 100 Beschäftigtekeywordtag könnten bei der Bertelsmann-Tochter Mohndruck zusätzlich auf der Lohnliste stehen - würden nicht die meisten der 2400 Arbeitnehmer 22 Monate lang unbezahlte Überstunden schieben . 
Beschaeftigter_s28694_f1	Von den einst über 100 Beschäftigtenkeywordtag war zu diesem Zeitpunkt noch etwa die Hälfte übriggeblieben . 
Beschaeftigter_s28702_f1	Parallel dazu gründeten die heute 37 Beschäftigtenkeywordtag das Ökozentrum , das als Betreibergesellschaft die Produktion auf Pachtbasis übernahm . 
Beschaeftigter_s29700_f1	So war die Zahl der Beschäftigtenkeywordtag im Jahresdurchschnitt um sechseinhalb Prozent niedriger als 1993 . 
Beschaeftigter_s29746_f1	Wie eine andere Verteilung der Arbeit in diesem Land nur gelingen kann , wenn der gewerkschaftliche Vorstoß Widerhall findet , sich zur gesellschaftlichen Kampagne gegen Arbeitslosigkeit und für Zeitsouveränität auch der einzelnen Beschäftigtenkeywordtag auswächst ; 
Beschaeftigter_s29802_f1	Die im Durchschnitt 76 ( 52 ) Beschäftigtenkeywordtag erlösten pro Kopf 330 000 ( 280 000 ) Mark . 
Beschaeftigter_s29811_f1	Der neue Inhaber übernimmt alle 1900 Beschäftigtenkeywordtag und führt die Standorte in Wiesbaden , Verona , den USA , Brasilien und Südkorea in der bisherigen Form fort . 
Beschaeftigter_s29957_f1	Von den 550 Beschäftigtenkeywordtag des alten Werkes am Stammsitz sollen am Ende rund 400 ins nicht weit entfernte Friedberg wechseln . 
Beschaeftigter_s29965_f1	Auch die Zahl der Beschäftigtenkeywordtag nahm um ein Zehntel auf 9000 zu . 
Beschaeftigter_s30491_f1	Für Friedberg haben Marktnähe und niedrige Transportkosten gesprochen , aber auch die Qualifikation der Beschäftigtenkeywordtag . 
Beschaeftigter_s30668_f1	Beschäftigtekeywordtag des öffentlichen Dienstes gingen in diesem Jahr massiv gegen Arbeitszeiterhöhungen und rigorose Einsparungen der Regierung Lafontaine auf die Straße . 
Beschaeftigter_s30808_f1	Über den Löffel balbiert werden Steuerzahler , ehrliche Unternehmer und Beschäftigtekeywordtag , deren Firmen der Schmutzkonkurrenz unterliegen und Pleite gehen . 
Beschaeftigter_s31082_f1	600 Beschäftigtekeywordtag arbeiten derzeit kurz . 
Beschaeftigter_s31253_f1	Die Bestellungen würden nicht nur zur Sicherung der etwa 3300 Stellen in der Dasa-Raumfahrt beitragen , sondern nun könne die Fluktuation auch wieder mit neuen Beschäftigtenkeywordtag ersetzt werden . 
Beschaeftigter_s32947_f1	Unter den 115 Millionen Beschäftigtenkeywordtag befinden sich also rund 38 Millionen potentielle Arbeitslose . 
Beschaeftigter_s32952_f1	Kollektivbetriebe gehören in der Regel den dortkeywordtag Beschäftigtenkeywordtag , meist mit kleinen Anteilen der jeweiligen Gemeinde , und sie sind nicht verpflichtet , die sozialen Leistungen anzubieten , die es `` beim Staat '' gibt . 
Beschaeftigter_s32953_f1	`` Wir glauben nicht , daß die sozialen Aufgaben von den Betrieben geleistet werden müssen , sondern von der Gesellschaft '' , sagt Mo Xiaoping , Manager der Wanxiang-Gruppe in Hangzhou , einem Kollektiv mit rund 60 Unternehmen und 35 000 Beschäftigtenkeywordtag . 
Beschaeftigter_s33450_f1	Einen Teil der übertariflichen Weihnachtsgaben bekommen die Beschäftigtenkeywordtag einiger Einzelhändler in diesem Jahr in Naturalien . 
Beschaeftigter_s33459_f1	Seit einigen Jahren ist es beispielsweise beim Kölner Kaufhof Praxis , außer einem 13. Monatsgehalt als `` Dankeschön '' den Beschäftigtenkeywordtag zum Christfest einen Warengutschein von 200 Mark unter den Baum zu legen . 
Beschaeftigter_s33465_f1	Zum einen bekommen die Beschäftigtenkeywordtag Firmenrabatte . 
Beschaeftigter_s33492_f1	Nach bisherigen Angaben von AEG-Chef Ernst Georg Stöckl steht fest , daß das Unternehmen sich von der Energietechnik ( dazu gehören Energieverteilung und Komponenten wie etwa Motoren ) und der Industrieautomatisierung ( Automatisierungstechnik ohne die entsprechende Post-Sparte ) mit einem Umsatz von zusammen 3,6 Milliarden Mark und 20 000 Beschäftigtenkeywordtag trennen will . 
Beschaeftigter_s34411_f1	Ende Oktober hatte HP 102 300 Beschäftigtekeywordtag . 
Beschaeftigter_s34550_f1	Wieder etwas hoffnungsvoller sind die 300 Beschäftigtenkeywordtag im Zweigwerk Peißenberg des zur Dasa gehörenden Triebwerkherstellers MTU . 
Beschaeftigter_s34843_f1	Durch das neue Gesetz zum Schutz der Beschäftigtenkeywordtag vor sexueller Belästigung am Arbeitsplatz werden die Rechte von Frauen in keiner Weise verbessert . 
Beschaeftigter_s35080_f1	Die Tatsache , daß knapp ein Viertel aller westdeutschenkeywordtag Beschäftigtenkeywordtag in den Genuß der `` 35 '' kommt , ist nur ein Erfolg für die Statistik . 
Beschaeftigter_s35107_f1	So halbierte zum Beispiel die deutsche Schuhindustrie die Zahl ihrerkeywordtag Beschäftigtenkeywordtag von 1984 bis 1994 von 46 000 auf 23 000 . 
Beschaeftigter_s35377_f1	Diekeywordtag Denkfabrikkeywordtag mitkeywordtag ihrenkeywordtag 3000 Beschäftigtenkeywordtag ist zugleich Initiator des `` Joint Venture Silicon Valley '' ( JVSV ) , das Unternehmen , Politik und Wissenschaft in 13 gemeinsamen Arbeitsgruppen vereint . 
Beschaeftigter_s36257_f1	Der neue Arbeitgeber muß innerhalb von zwei Wochen die Bescheinigung der gewählten Krankenkasse bekommen und danach dann den Beschäftigtenkeywordtag anmelden . 
Beschaeftigter_s36545_f1	Dank des schnellen Wachstums stieg die Zahl der Beschäftigtenkeywordtag im zu Ende gehenden Jahr um rund 1000 auf 5700 , im kommenden sollen noch einmal maximal 700 neue Arbeitsplätze geschaffen werden . 
Beschaeftigter_s36557_f1	Wie das Unternehmen bestätigte , werden den drei Führungskräften Unregelmäßigkeiten bei der Schulung ehemaliger Beschäftigterkeywordtag der früheren DDR-Außenhandelsfirma Metallurgiehandel vorgeworfen . 
Beschaeftigter_s36685_f1	Die dortige Firma Braspet nimmt 1997 mit 390 Beschäftigtenkeywordtag 66 Millionen Dollar ein . 
Beschaeftigter_s36831_f1	`` Heute arbeiten in der Stadt wieder rund 80 Glasherstellerkeywordtag aller Art mitkeywordtag zusammen etwa 700 Beschäftigtenkeywordtag '' , sagt Amtsleiter Greiner-Well . 
Beschaeftigter_s36975_f1	1991 , also vor einer ganzen Reihe von Erwerben , zählte der Verbund noch 6800 Beschäftigtekeywordtag . 
Beschaeftigter_s37045_f1	Bei O & K Mining sorgen 600 Beschäftigtekeywordtag für 450 Millionen Mark Umsatz . 
Beschaeftigter_s37107_f1	Obwohl seit September etwa ein Zehntel der 1100 Beschäftigtenkeywordtag kurzarbeitet , macht sich Walther keine allzu großen Sorgen . 
Beschaeftigter_s37298_f1	Die Zahl der Beschäftigtenkeywordtag sank um 500 auf 4800 . 
Beschaeftigter_s37409_f1	Unabhängig davon ist beim Arbeitsamt vorsorglich die Gewährung von Kurzarbeitergeld beantragt , denn in einer Mitteilung an die Beschäftigtenkeywordtag heißt es , daß die Produktion des Polo und des Golf in der nächsten Woche voraussichtlich zum Erliegen komme , wenn in Spanien kurzfristig keine Einigung erzielt werde . 
Beschaeftigter_s37448_f1	Wie berichtet , will sich der Multi von diesem Zweigkeywordtag mitkeywordtag rund 15 800 Beschäftigtenkeywordtag und Erlösen von umgerechnet gut 6,8 Milliarden Mark in vier Gesellschaften trennen . 
Beschaeftigter_s37516_f1	Die Belegschaft schrumpfte zugleich um 148 auf noch rund 4200 Beschäftigtekeywordtag . 
Beschaeftigter_s37529_f1	Rationalisierungen und die Verlagerung von arbeitsintensiver Produktion ins Werk Tschechien werden sich vor allem beim 1996 übernommenen Konkurrenten FRZ Metallwarenfabrik in einem weiteren Stellenabbau niederschlagen - von ursprünglich 426 Beschäftigtenkeywordtag sollen dort Ende 1997 noch etwa 260 übrig sein . 
Beschaeftigter_s37542_f1	Derzeit arbeiten 170 Beschäftigtekeywordtag bei Ültje in Emden . 
Beschaeftigter_s37606_f1	`` Den Beschäftigtenkeywordtag ist es nicht weiter zuzumuten , ohne Bezahlung weiterzuarbeiten '' , betonte Gesamtbetriebsratschefin Silke Striezel . 
Beschaeftigter_s37628_f1	Diekeywordtag kleinekeywordtag deutschekeywordtag Aktiengesellschaftkeywordtag mitkeywordtag 30 Beschäftigtenkeywordtag an der Isar und 20 im Marketing in San Francisco gilt als einer der Pioniere beim Aufbau dreidimensionaler Benutzerwelten im Internet . 
Beschaeftigter_s37895_f1	Die Zahl der Beschäftigtenkeywordtag kletterte weltweit um 200 auf 18 000 , nahm aber hierzulande um 459 auf 3511 ab . 
Beschaeftigter_s38094_f1	Bis Mitte 2000 sind den 1700 Beschäftigtenkeywordtag des Gütersloher Medienhauses Mohndruck ihre Arbeitsplätze sicher . 
Beschaeftigter_s38110_f1	Unternehmen achten bei Reisen von Beschäftigtenkeywordtag verstärkt auf die Kosten . 
Beschaeftigter_s38160_f1	Die Beschäftigtenkeywordtag der drei unter Ott & Heinemann firmierenden Häuser in Frankfurt sind bereits gekündigt . 
Beschaeftigter_s38164_f1	Alle Beschäftigtenkeywordtag können Optionen erwerben 
Beschaeftigter_s38169_f1	Anläßlich seines 125jährigen Jubiläums bietet das Geldhaus den Beschäftigtenkeywordtag neben Belegschaftsaktien erstmals zwei Kaufoptionen je erworbenem Papier an . 
Beschaeftigter_s38188_f1	Die noch fast 25 000 Beschäftigtenkeywordtag erhalten einen neuen Arbeitgeber . 
Beschaeftigter_s38192_f1	`` Die Beschäftigtenkeywordtag in der Chemie bezahlen den Kauf von Roussel '' , kritisiert Hans-Werner Krauss von der gewerkschaftlichen Oppositionsgruppe Standort Forum . 
Beschaeftigter_s38279_f1	Was auf Dauer von Hoechst bleibt , wo der Verbund in einigen Jahren steht - Beschäftigtekeywordtag und Aktionäre verlangen Antworten . 
Beschaeftigter_s38380_f1	Die Mehrheit der Beschäftigtenkeywordtag des Spieleherstellers Ravensburger hat einer Erhöhung der Wochenarbeitszeit um zwei Stunden , verbunden mit einer Arbeitsplatzgarantie , zugestimmt . 
Beschaeftigter_s38385_f1	Die Beschäftigtenkeywordtag werden vom 1. Juli an 38 statt bisher 36 Stunden in der Woche tätig sein . 
Beschaeftigter_s38408_f1	Es wird nach der Übernahme mit 26 000 Beschäftigtenkeywordtag 10,4 Milliarden Dollar umsetzen sowie über Kraftwerke mit 17 000 Megawatt Leistung und mehr als zehn Milliarden Tonnen Kohlereserven verfügen . 
Beschaeftigter_s38822_f1	Zu DDR-Zeiten waren die Leuna-Werke mitkeywordtag 28 000 Beschäftigtenkeywordtag der größte Chemiebetrieb des Landes . 
Beschaeftigter_s38827_f1	Zusätzlich 130 Beschäftigtekeywordtag kämen bei Leuna 2000 unter . 
Beschaeftigter_s38903_f1	Heute liegen die trockenen und ökologisch unbedenklicheren Kennzeichnungs-Stifte auf den Schreibtischen - wenn die Beschäftigtenkeywordtag nicht , und das soll vorkommen , die bequemere Flüssigvariante aus der eigenen Tasche bezahlen . 
Beschaeftigter_s38923_f1	Die Zahl der Beschäftigtenkeywordtag stieg um 60 Prozent auf rund 920 Leute , ging jedoch dann leicht zurück . 
Beschaeftigter_s39163_f1	Christiania hätte mit einem Stab von 8000 Beschäftigtenkeywordtag und einer Bilanzsumme von umgerechnet rund 65 Milliarden Mark Norwegens führender Finanzkonzern werden sollen . 
Beschaeftigter_s39167_f1	Deshalb blockierten Heyerdahl und Rökke einen Zusammenschluß , der von den Politikern , dem überwiegenden Teil des Wirtschafts-Establishments , den Gewerkschaften und den Beschäftigtenkeywordtag gutgeheißen worden war . 
Beschaeftigter_s39253_f1	Fast 1200 Beschäftigtekeywordtag betroffen / 
Beschaeftigter_s39261_f1	382 Beschäftigtenkeywordtag bekommen andere Tätigkeiten angeboten . 
Beschaeftigter_s39264_f1	In einem Gespräch mit der Tageszeitung Liberation sagte er , wenn die Beschäftigtenkeywordtag die Produktion nicht bald wieder aufnähmen , werde das Werk möglicherweise vor dem geplanten Termin am 31. Juli geschlossen . 
Beschaeftigter_s39265_f1	Renault hatte das Aus für Vilvoordekeywordtag mitkeywordtag 3100 Beschäftigtenkeywordtag Ende Februar überraschend angekündigt . 
Beschaeftigter_s39273_f1	Die Beschäftigtenkeywordtag hatten versucht , die Absperrungen vor dem Sitz der flämischen Regionalregierung in Brüssel zu durchbrechen . 
Beschaeftigter_s39288_f1	Das monatliche Einkommen der Beschäftigtenkeywordtag bleibt dabei konstant . 
Beschaeftigter_s39292_f1	Derzeit gibt es unter den 2000 Beschäftigtenkeywordtag 50 Auszubildende . 
Beschaeftigter_s39295_f1	Eingebettet ist die Rastatter Betriebsvereinbarung in das Ende Februar abgeschlossene Rahmenabkommen für alle 134 000 inländischenkeywordtag Beschäftigtenkeywordtag von Mercedes-Benz . 
Beschaeftigter_s39501_f1	Er umfaßt die Spezialchemie-Spartekeywordtag , mitkeywordtag 25 000 Beschäftigtenkeywordtag zweitgrößtes Hoechst-Geschäftsfeld . 
Beschaeftigter_s39532_f1	Für den Umsatz von umgerechnet 220 Millionen Mark sorgen 880 Beschäftigtekeywordtag . 
Beschaeftigter_s39583_f1	Von den 564 Beschäftigtenkeywordtag arbeiten in Sachsen-Anhalt derzeit 120 . 
Beschaeftigter_s39781_f1	Gleichzeitig sank der Anteil der Beschäftigtenkeywordtag im verarbeitenden Gewerbe von 29 auf 19 Prozent . 
Beschaeftigter_s39937_f1	Eine gute Nachricht hat Wächter für seinekeywordtag Beschäftigtenkeywordtag und den Frankfurter Arbeitsmarkt . 
Beschaeftigter_s40060_f1	Im vergangenen Jahr gabkeywordtag es noch 1400 Unternehmenkeywordtag mitkeywordtag rund 7000 Beschäftigtenkeywordtag in dieser Branche . 
Beschaeftigter_s40393_f1	1996 hatte der PC-Hersteller 1300 Beschäftigtekeywordtag nach Hause geschickt . 
Beschaeftigter_s40447_f1	3Com zählt zu den global führenden Unternehmen auf dem Gebiet PC-gestützter Datenverbindung und erlöste mit 13 500 Beschäftigtenkeywordtag zuletzt 5,5 Milliarden Dollar . 
Beschaeftigter_s40457_f1	Kantner dagegen spricht auch von `` hausgemachten Problemen '' , die unter anderen die knapp 1000 Beschäftigtenkeywordtag ausbaden müssen . 
Beschaeftigter_s40493_f1	Eine Übersicht des Wirtschafts- und Sozialwissenschaftlichen Instituts ( WSI ) des DGB zeigt , daß für 9,3 Millionen Beschäftigtekeywordtag Lohn- und Gehaltserhöhungen von im Schnitt 1,5 Prozent vereinbart wurden . 
Beschaeftigter_s40499_f1	Ihr überwiegender Inhalt : Beschäftigtekeywordtag können vom 55. Lebensjahr an ihre Arbeitszeit um die Hälfte reduzieren und erhalten noch 85 Prozent des bisherigen Nettoverdienstes . 
Beschaeftigter_s40565_f1	Die Bremer Nordfinanz-Bank ( NF ) rechnet sich für ihre Schadenersatzklage gegen die Dresdner Bank und zwei ehemalige leitende Angestellte ( siehe FR von gestern ) gute Chancen aus , weil auch schon Strafermittlungen gegen die beiden Banker und zwei noch amtierende Beschäftigtekeywordtag der Dresdner laufen . 
Beschaeftigter_s40572_f1	Diesen Betrag will sich das Bremer Institut jetzt von der Dresdner und derenkeywordtag ehemaligenkeywordtag Beschäftigtenkeywordtag zurückholen , weil sie angeblich `` genau über diese Dinge Bescheid wußten '' und die betrügerische Anlagefirma `` künstlich am Leben gehalten '' hätten . 
Beschaeftigter_s40698_f1	Danach soll die Anstalt , die 1995 die Arbeit der aufgelösten Treuhand weiterführte , Anfang 1998 noch 1200 Beschäftigtekeywordtag ( derzeit 1600 ) und ein Jahr später 600 zählen . 
Beschaeftigter_s40760_f1	Diekeywordtag Gruppekeywordtag mitkeywordtag über 1400 Beschäftigtenkeywordtag stärke weiter konsequent ihr Kerngeschäft Programm . 
Beschaeftigter_s40797_f1	Von den weltweit 4400 Beschäftigtenkeywordtag arbeiten 800 in Deutschland . 
Beschaeftigter_s40854_f1	US-Börse lockt mit Optionen für Beschäftigtekeywordtag / 
Beschaeftigter_s40874_f1	Mit der Notiz jenseits des Atlantiks will SAP vor allem die Voraussetzung dafür schaffen , Beschäftigtekeywordtag mit Aktien und Aktienoptionen am Firmenerfolg zu beteiligen . 
Beschaeftigter_s40876_f1	Darüber hinaus plant das Unternehmen , das Instrument Optionen auch in Deutschland für alle Beschäftigtenkeywordtag und ihr Management einzusetzen . 
Beschaeftigter_s40894_f1	Im seit April laufenden Geschäftsjahr möchte der Konzern mitkeywordtag seinenkeywordtag 1550 Beschäftigtenkeywordtag ( davon 902 hierzulande ) den Umsatz um mindestens ein Zehntel steigern . 
Beschaeftigter_s41005_f1	Die Zahl der Beschäftigtenkeywordtag erhöhte sich mit den Neuerwerbungen um etwa 1500 auf knapp 14 500 , ohne diesen Effekt wurden rund 100 neue Stellen geschaffen . 
Beschaeftigter_s41042_f1	Der Stadtstaat will die Produktion mit 200 der 350 Beschäftigtenkeywordtag weiterführen . 
Beschaeftigter_s41107_f1	Die Beschäftigtenkeywordtag wurden über die Vorstellungen bereits informiert . 
Beschaeftigter_s41129_f1	Für die 1470 Beschäftigtenkeywordtag von Carl Zeiss Jena ist ein neuer Tarifvertrag vereinbart worden . 
Beschaeftigter_s41230_f1	Nach der Restrukturierung sollen von den derzeit 150 Beschäftigtenkeywordtag in Rheine noch maximal 70 dort arbeiten . 
Beschaeftigter_s41316_f1	Beschäftigtekeywordtag müssen sich sorgen 
Beschaeftigter_s41324_f1	Für die Beschäftigtenkeywordtag gilt dagegen eher der Slogan `` Meine Sorge , Volksfürsorge '' . 
Beschaeftigter_s41349_f1	Insgesamt seien diese in 913 Betriebenkeywordtag mitkeywordtag insgesamt 1,5 Millionen Beschäftigtenkeywordtag erhobenen repräsentativen Urteile , die das Münchner Ifo-Institut alljährlich zweimal ermittelt , aber `` etwas freundlicher '' ausgefallen als zuvor . 
Beschaeftigter_s41399_f1	Die Produktivität will Henne von 3100 auf 4000 Hektoliter je Beschäftigtemkeywordtag erhöhen , `` aber nicht durch Stellenabbau , sondern durch höheren Absatz '' . 
Beschaeftigter_s41542_f1	Der Abbau betrifft nach Angaben der Arbeitnehmervertreter vor allem älterekeywordtag Beschäftigtekeywordtag in Bremen . 
Beschaeftigter_s41560_f1	Die Zahl der Beschäftigtenkeywordtag wurde um 300 auf 3300 gesenkt , ein noch größerer Abbau ist eingeleitet . 
Beschaeftigter_s41654_f1	Mit einer Jahresproduktion von 15 Millionen Tonnen Rohstahl , einem Umsatz von elf Milliarden Mark und 24 000 Beschäftigtenkeywordtag ist TKS in Europa Branchenprimus . 
Beschaeftigter_s41674_f1	Multis bauen Verbindung zu einer bisher mittelständischen Branchekeywordtag mitkeywordtag 120 000 Beschäftigtenkeywordtag auf / 
Beschaeftigter_s41706_f1	Bei den ersten Großaktionen schalteten sie 100 Leitungen hintereinander , so daß die Beschäftigtenkeywordtag am Anfang der Reihe immer zuerst abheben mußten . 
Beschaeftigter_s41708_f1	Die Anlagen verteilen die Anrufe nicht nur nach beliebigen Kriterien auf die Apparate , die , wie bei der Dietzenbacher Agentur Phone Partner , teilweise bei den Beschäftigtenkeywordtag zu Hause stehen , sondern verwalten auch die Warteschlange und ermöglichen die sekundengenaue Auswertung von Daten . 
Beschaeftigter_s41712_f1	Der Dauerstreß fordert die Beschäftigtenkeywordtag extrem . 
Beschaeftigter_s41719_f1	Sie werden allerdings zuweilen auch von den Beschäftigtenkeywordtag zerrissen , betonen die Inhaber . 
Beschaeftigter_s42007_f1	Beschäftigtekeywordtag protestieren gegen Stellenabbau 
Beschaeftigter_s42010_f1	Etwa 7000 der 8500 Beschäftigtenkeywordtag in den hiesigen Werken des Bahntechnikkonzerns Adtranz haben gegen den von der Geschäftsführung geplanten Personalabbau protestiert . 
Beschaeftigter_s42131_f1	Vor allem setzt er auf das Know-how der heute 60 Beschäftigtenkeywordtag , um auch auf dem zweitwichtigsten europäischen Markt für Mietautos - nach Deutschland - die Kurve zu kriegen . 
Beschaeftigter_s42219_f1	Nach HBV-Ansicht tragen die Entscheidungen über die künftige Struktur des Bankriesen `` deutlich '' den Stempel von Schmidt , der daskeywordtag vereinigtekeywordtag Institutkeywordtag mitkeywordtag rund 740 Milliarden Mark Bilanzsumme und 40 000 Beschäftigtenkeywordtag führen soll . 
Beschaeftigter_s42528_f1	In über 100 Wirtschaftszweigenkeywordtag mitkeywordtag rund 11,6 Millionen Beschäftigtenkeywordtag sei das Entgelt gesichert worden . 
Beschaeftigter_s42711_f1	Am Ende einer Reihe von Erfindungen steht der Siemens-Konzern mitkeywordtag mehr als 95 Milliarden Mark Umsatz und nun 386 000 Beschäftigtenkeywordtag - ein Erfolg , den der Vorstand mit Hunderten Gästen am 12. Oktober im Berliner ICC feiern will . 
Beschaeftigter_s42728_f1	Auch die Beschäftigtenkeywordtag versucht Werner Siemens einzubinden . 
Beschaeftigter_s42733_f1	Das Gemeinschaftsgefühl als Siemens-Familie wird zwar heute noch gepflegt , doch angesichts des Umbaus gehen manche Beschäftigtekeywordtag auf Distanz - oder gar zu einer Demonstration . 
Beschaeftigter_s42918_f1	Die Gewerkschaft verurteilt die Ausweitung der Sonntagsöffnung als Angriff auf `` die Reste des freien Wochenendes '' der Beschäftigtenkeywordtag . 
Beschaeftigter_s43035_f1	Das neue Unternehmen stünde mitkeywordtag 147 000 Beschäftigtenkeywordtag für einen Jahresumsatz von 15,3 Milliarden Dollar . 
Beschaeftigter_s43159_f1	Einer Erklärung der Franken zufolge sind von den Änderungen in den nächsten drei Jahren etwa 400 Beschäftigtekeywordtag betroffen . 
Beschaeftigter_s43176_f1	Die Übernahme der Gruppe mit 212 Filialen , rund 4500 Beschäftigtenkeywordtag , die sämtlich übernommen werden sollen , und einem Nettoumsatz von 1,1 Milliarden Mark soll Anfang 1998 über die Bühne gehen . 
Beschaeftigter_s43234_f1	Insgesamt ermittelt die Behörde gegen mehr als ein Dutzend Beschäftigtekeywordtag des Unternehmens . 
Beschaeftigter_s43443_f1	BA-Präsident Bernhard Jagoda hält dies insbesondere bei Nebenjobs von anderweitig versicherten Arbeitnehmern - das entspricht etwa einem Viertel der rund 5,6 Millionen geringfügigkeywordtag Beschäftigtenkeywordtag - für dringend notwendig . 
Beschaeftigter_s43447_f1	Die Beschäftigtenkeywordtag müßten ihr Einkommen dann zwar wieder individuell versteuern , erläutert das DIW , aufgrund der bestehenden Freibeträge würde jedoch eine Mehrheit der Jobber nichts ans Finanzamt überweisen müssen . 
Beschaeftigter_s43448_f1	Verlierer wären aber vor allem Ehefrauen , die rund 40 Prozent der ausschließlich geringfügig Beschäftigtenkeywordtag stellen . 
Beschaeftigter_s43602_f1	Als Folge der Finanzkrise erklärte sich am Freitag eines der führenden Wertpapierhäuser des Landes , Coryo Securities , mitkeywordtag 1100 Beschäftigtenkeywordtag für zahlungsunfähig . 
Beschaeftigter_s43759_f1	Die Erwerbung bringt einen Umsatz von rund 700 Millionen Mark und 600 Beschäftigtekeywordtag mit . 
Beschaeftigter_s43895_f1	Der Chef der Quelle Bank führt das größte Direktinstitut in Deutschland , 540 000 Bundesbürger hören auf seinekeywordtag Beschäftigtenkeywordtag . 
Beschaeftigter_s43918_f1	Die Zahl der Beschäftigtenkeywordtag stieg um 72 auf 317 . 
Beschaeftigter_s44203_f1	Vor allem die Besteuerung der Zuschläge sei für die Beschäftigtenkeywordtag `` unzumutbar '' , rügt der DGB die Reformer . 
Beschaeftigter_s44337_f1	Die Löhne und Gehälter der 287 Beschäftigtenkeywordtag des Drehmaschinenherstellers Pittler in Langen sind nach dem Konkursantrag durch Ausfallgeld bis einschließlich März gesichert . 
Beschaeftigter_s45944_f2	Die 20 000 Beschäftigtenkeywordtag im Finanzbereich stellen zwar nur ein Zehntel aller Beschäftigtenkeywordtag dar , bringen aber ein Viertel der gesamten Lohnsteuer auf . 
Beschaeftigter_s45956_f1	Auf den statistischen Durchschnitt und auf die Kaufkraft bezogen stehen die Löhne und Gehälter der etwa 200 000 abhängigkeywordtag Beschäftigtenkeywordtag und der Sozialstaat an der Weltspitze . 
Beschaeftigter_s45962_f1	Die Deutsche Bank Luxemburg beispielsweise hatkeywordtag nur 241 Beschäftigtekeywordtag . 
Beschaeftigter_s45964_f1	Der Durchschnittsverdienst der 241 Beschäftigtenkeywordtag der Deutschen Bank liegt bei 130 000 Mark pro Jahr . 
Beschaeftigter_s45984_f1	Erstens ist die Zahl der Pendler aus den umliegenden Staaten Deutschland , Belgien und Frankreich recht hoch ( 28 Prozent der abhängigkeywordtag Beschäftigtenkeywordtag ) ; 
Beschaeftigter_s49287_f1	In 80 Briefzentren der Post haben Beschäftigtekeywordtag in der Nacht zum Freitag für bis zu einer Stunde die Arbeit niedergelegt . 
Beschaeftigter_s49290_f1	Mehr als 20 000 Beschäftigtekeywordtag hätten sich an dem Protest beteiligt , teilte die Deutsche Postgewerkschaft ( DPG ) am Freitag in Frankfurt am Main mit . 
Beschaeftigter_s49357_f1	Und nach der neuesten Studie des Prognos-Instituts gilt nicht einmal mehr die Behauptung , daß an jedem Arbeitsplatz im Bergbau mindestens 1,3 Beschäftigtekeywordtag in Zulieferbetrieben hängen . 
Beschaeftigter_s49426_f1	Davon wären bis zu 20 000 Beschäftigtekeywordtag betroffen . 
