wissen_s5298_f0	Wirkeywordtag 	wissen 	aber auch : Die Verhältnisse sind schwieriger , als wir alle wollen ; 
beurteilen_s5299_f1	sind differenziert zu beurteilen . 
beurteilen_s5986_f1	Skeptisch 	beurteilte 	erkeywordtag von palästinensischer Seite gewünschte Direktinvestitionen im Gaza-Streifen und Westjordanland . 
beurteilen_s6008_f3	Auch wenn es schwierig sei , die Sachlage im Einzelfall zu beurteilen , dürften sich Christen nicht davon abhalten lassen , `` für möglicherweise an Leib und Leben bedrohte Menschen '' einzustehen . 
beurteilen_s6313_f1	Der 2. Senat entschied am Montag , daß im Einzelfall 	beurteilt 	werden müsse , ob der Jurist Distanz zu seiner Vergangenheit gezeigt habe und politisch integer sei ( Az. : 2 C 21 / 94 ) . 
beurteilen_s10007_f1	Deutlich zurückhaltender als Regierung und Institute 	beurteilt 	der DIHT die Rolle des privaten Konsums . 
beurteilen_s11632_f1	`` Gerade die Nicht-Mathematiker haben zu beurteilen , welche mathematischen Kenntnisse und Fähigkeiten nach dem Schulabschluß zu erwarten sein sollen . '' 
beurteilen_s14414_f1	Sie mußten alternativen Deutungen nachgehen , soweit diesekeywordtag strafrechtlich milder zu beurteilen waren . 
beurteilen_s18404_f1	So hatte der Mann argumentiert , der Kauf von Alkohol sei auch kein geeignetes Indiz , um eine fehlende Fahrtauglichkeit 	beurteilen 	zu können . 
beurteilen_s18601_f1	Neben der Bonität der Kunden sollen bei Kreditanträgen in Zukunft auch Umweltfolgen der Investitionen 	beurteilt 	und gewürdigt werden . 
beurteilen_s20251_f1	Wie 	beurteilen 	Siekeywordtag dann die rotgrüne Koalition mit PDS-Duldung in Sachsen-Anhalt ? 
beurteilen_s21640_f1	Der Sachverständigenrat 	beurteilt 	damit die konjunkturelle Entwicklung im Inland weniger optimistisch als die sechs führenden deutschen Wirtschaftsforschungsinstitute . 
beurteilen_s23324_f1	Es sei noch zu früh , um abschließend zu beurteilen , ob der Anschlag den USA oder der Regierung Saudi-Arabiens gegolten habe , sagte ein Sprecher des US-Verteidigungsministeriums . 
beurteilen_s24623_f1	Die Mehrheit der Bevölkerung 	beurteilte 	seine erste Amtszeit trotz der deutlichen Neigung des Präsidenten zum Autoritarismus positiv und bestätigte den Nachfahren japanischer Einwanderer im April dieses Jahres mit deutlicher Mehrheit . 
beurteilen_s25004_f2	Die Bundesrichter 	beurteilen 	eskeywordtag anders , und weisen die Klage der Brandt-Witwe ab . 
beurteilen_s26422_f1	Die Leser seien kritisch genug , die Werbung entsprechend zu beurteilen , schließlich seien die Texte eindeutig als Anzeige gekennzeichnet . 
beurteilen_s29294_f1	Ich bin jetzt achtundfünfzig , es kann sein , daß auch mich das Alter schon eingeholt hat , daskeywordtag kann ichkeywordtag nicht 	beurteilen 	. 
beurteilen_s29500_f1	Solange die KPC an dem ( noch ) geplanten Zusammenhang - wie reduziert auch immer - ihrer Ökonomie festhält , besteht nämlich der ausländische Verdacht , daß der Yuan doch noch als `` künstlich '' staatlich fixierter 	beurteilt 	wird , weil er noch immer als innerchinesisches `` Verrechnungsgeld '' auch die Verluste der Staatsbetriebe mitträgt . 
beurteilen_s30088_f3	Bundesgerichtshofkeywordtag 	beurteilt 	Rechtskategoriekeywordtag jetzt anders als im Fall der NS-Juristen 
beurteilen_s32091_f1	Zwar weist Schillo darauf hin , das dieses `` an allen Schauplätzen des Massentourismus feststellbare Verhalten nicht abwertend 	beurteilt 	werden sollte '' , dessen ungeachtet aber plädiert der Planer im besten touristischen Hardliner-Jargon dafür , `` daß eine vielfältige Erlebnis- und Animationsumgebung im direkten Umfeld des Urlaubers geschaffen wird . '' 
beurteilen_s33970_f1	Spaniens Ministerpräsident Felipe González , Gastgeber des baldigen EU-Gipfels , versprach , sich dafür einzusetzen , 	beurteilte 	Erfolgschancenkeywordtag aber skeptisch . 
beurteilen_s35579_f1	Umstrittene Gutachter 	beurteilen 	NS-Militärjustizkeywordtag 
beurteilen_s37586_f1	Den Schadenverlauf des Berichtsjahres 	beurteilt 	erkeywordtag als überraschend günstig . 
beurteilen_s39134_f3	Im April 1998 muß der neue Mann im Frankfurter Eurotower einen Bericht vorlegen , derkeywordtag die Eignung aller Kandidaten 	beurteilt 	. 
beurteilen_s39365_f1	Nun soll noch die in der Branche angesehene Beratungsfirma Strathcona Mineral Services im Auftrag von Bre-X aufgrund eigener Proben den voraussichtlichen Umfang des Vorkommens 	beurteilen 	. 
beurteilen_s39775_f1	`` Die Vergangenheit ist ein anderes Land '' , 	beurteilte 	jüngst der Guardian die Kluft zwischen damals und heute . 
