bewaeltigen_s3254_f1	`` Angesichts der großen Aufgabe , die demokratische und wirtschaftliche Umgestaltung zu bewältigen , sind direkter Rat und tatkräftige Hilfe von Mensch zu Mensch wichtig . '' 
bewaeltigen_s5152_f2	Der internationale Vergleich deutet darauf hin , daß die westdeutsche Wirtschaft den Strukturwandel der vergangenen Jahrzehnte besser 	bewältigt 	hat als viele andere Länder . 
bewaeltigen_s5595_f1	Siekeywordtag müssen tagtäglich den Konflikt um Überstunden in den Betrieben 	bewältigen 	. 
bewaeltigen_s7092_f1	Denn nur wenn der sich ändere , könne die Umweltkrise 	bewältigt 	werden . 
bewaeltigen_s7553_f1	9. Berlins größte Herausforderung , nämlich das beispielhafte Zusammenwachsen der Menschen , kann mit einer Spalterpartei nicht 	bewältigt 	werden . 
bewaeltigen_s7555_f1	10. Die weiter anstehenden großen Aufgaben - Fusion mit Brandenburg , - Vorbereitung auf die Rolle der zukünftigen Regierungshauptstadt und die - unabweisbare , aber sozialverträgliche Haushaltskonsolidierung sind nicht zu bewältigen , wenn Berlin von einer Koalition weiter regiert wird , die ein breites Mißtrauensvotum bei Wahlen ignoriert und deren führende Partei einen großen Teil der Bevölkerung des ehemaligen Ost-Berlin aus der demokratischen Gemeinschaft ausgrenzt . 
bewaeltigen_s7556_f1	10. Berlinkeywordtag kann seine Umstrukturierung zu einer bürgernah dezentral und dennoch effektiv verwalteten Großstadt nur 	bewältigen 	, wenn zwischen Senat und allen Bezirksverwaltungen ein konstruktives Klima vertrauensvoller Zusammenarbeit existiert . 
bewaeltigen_s7892_f1	Siekeywordtag können den Ansturm der Kunden kaum 	bewältigen 	. 
bewaeltigen_s8796_f1	Clinton zeigte in einem Telefonat mit Arafat Verständnis für den `` würdevollen Weg '' , wie der PLO-Chef `` diese sehr tragische Situation '' 	bewältigt 	habe . 
bewaeltigen_s9241_f1	Spanische Ängste vor dem islamischen Fundamentalismus sind zum guten Teil ohne realen Anlaß und , soweit begründet , nicht durch Militär zu bewältigen . 
bewaeltigen_s11451_f1	Manche Menschen , diekeywordtag nach dem Fall des Kommunismus nicht fähig sind , schnell genug die ihnen bisher unbekannten Ansprüche zu bewältigen , welche die neuen Verhältnisse an ihre Individualität und individuelle Verantwortung für sich selbst sowie für die Welt stellen , und deren Immunität gegen kollektivistische Versuchungen darüber hinaus infolge des langen Lebens im Kommunismus geschwächt ist , können leicht dem verlockenden Appell an etwas erliegen , wofür sie nichts tun mußten . 
bewaeltigen_s12657_f1	Daß bei einer langsamen Lösung die von Zagreb versprochene Weihnachtsmesse in Vukovar , der Symbolstadt für beide Seiten , ausfiele und in Belgrad die extrem nationalistische Opposition ihr Geschrei vom Verrat schon verstärken könnte , wäre als Herausforderung von den beiden jeweiligen ausgebufften Propagandaabteilungen wahrscheinlich zu bewältigen . 
bewaeltigen_s18568_f1	Hinter einer Säule haben die Helfer derweil Mühe , den Andrang an den mitgebrachten beiden Campingtoiletten zu bewältigen . 
bewaeltigen_s19871_f1	Würden diese je einen zusätzlichen Arbeitsplatz schaffen , hätten wirkeywordtag den größten Teil des Weges zur Vollbeschäftigung 	bewältigt 	. 
bewaeltigen_s20792_f1	Ein nicht gerade tiefschürfender Hinweis des Professors galt den USA , die er kurzerhand in den Rang der `` besten Demokratie '' erhob , weil siekeywordtag über zwei Jahrhunderte hinweg mit ihrem institutionellen Gerüst alle Entwicklungen und Krisen `` 	bewältigt 	'' habe . 
bewaeltigen_s22095_f1	Ein Sohn 	bewältigt 	den Tod des Vaters , der eine Doppelexistenz als Frau geführt hat und von ihm zugleich als Mörder seiner Mutter verdächtigt wird . 
bewaeltigen_s29748_f1	Um diese Aufgaben zu bewältigen , war der personelle Wechsel an der Spitze notwendig . 
bewaeltigen_s30468_f1	Der vom SPD-Vorstand getragene Antrag `` Arbeitsplätze für Deutschland '' ziele dagegen vorrangig darauf , aktuelle wirtschaftliche Probleme zu bewältigen . 
bewaeltigen_s32146_f1	Auch wenn das Problem der Atomwaffen juristisch nicht zu bewältigen sein sollte , weil es zu vielschichtig ist , so ist das in Den Haag vorgetragene Argument der Bundesregierung , es handle sich ausschließlich um ein politisches Problem , erst recht unzulänglich . 
bewaeltigen_s33572_f1	Bisher sei das Bündnis in seinen Strukturen zu statisch und zu sehr auf die Verteidigung Mitteleuropas beschränkt , um neue Mitglieder integrieren und Konflikte außerhalb der Mitte Europas 	bewältigen 	zu können , sagte Rühe vor den 500 Generälen und Admirälen . 
bewaeltigen_s34669_f1	Wieder andere lernen mit einem der berühmten How to do -Bücher , wie die von der Verfassung garantierte Verfolgung des Glücks fortan streßfrei zu bewältigen ist . 
bewaeltigen_s35619_f1	An diesem eher bitteren Resümee vermag auch das vom Weltsicherheitsrat der Vereinten Nationen vor kurzem in Den Haag eingesetzte internationale Tribunal nichts zu ändern , daskeywordtag ohne Macht einige der Verbrechen im Balkankrieg juristisch 	bewältigen 	soll . 
bewaeltigen_s38905_f1	manchmal zu lang für karrierebewußte Manager , eher zu bewältigen dagegen von Unternehmerpersönlichkeiten . 
