durchsetzen_s2133_f0	Die SPD hat im Vermittlungsausschuß von Bundestag und Bundesrat eine höhere faktische Besteuerung von Zinseinkünften 	durchgesetzt 	und die von der Bundesregierung geplante Anhebung der Freibeträge bei Vermögen- und Erbschaftsteuer verhindert . 
durchsetzen_s2500_f0	Es sei Sache der Union zu prüfen , ob erkeywordtag 	durchzusetzen 	sei . 
durchsetzen_s3649_f0	Politische Beobachter vertraten die Ansicht , Irak wolle lediglich testen , wie entschlossen der Sicherheitsrat sei , seine Forderung 	durchzusetzen 	. 
durchsetzen_s4056_f0	Grüne Realpolitiker um den Sprecher der Bundestagsfraktion , Joschka Fischer , wollen auf dem Parteitag Anfang Dezember in Bremen ein Votum für UN-Kampfeinsätze `` im Fall von Völkermord '' 	durchsetzen 	. 
durchsetzen_s4581_f0	Im Unterschied zu den meisten Siedler-Organisationen treten siekeywordtag jedoch dafür ein , notfalls Gewalt auch gegen die eigenen Landsleute anzuwenden , um ihre Ziele 	durchzusetzen 	. 
durchsetzen_s4690_f0	Der SPD-Vorsitzende Rudolf Scharping will die Zustimmung seiner Partei zum Einsatz von Tornado-Kampfflugzeugen der Bundeswehr in Bosnien 	durchsetzen 	. 
durchsetzen_s4831_f0	Ich teile eher die Auffassung der Frauen , die sagen , siekeywordtag möchten sich allein mit ihrer Persönlichkeit und mit dem , was sie können , 	durchsetzen 	. 
durchsetzen_s6472_f0	Die Deutsche Postgewerkschaft ( DPG ) hat den von der Telekom geplanten Stellenabbau akzeptiert und dafür einen verlängerten Kündigungsschutz 	durchgesetzt 	. 
durchsetzen_s7575_f0	16. Wenn dennoch eine knappe Mehrheit der Berliner SPD aus sicherlich wohlmeinenden staatstragenden Gründen eine Neuauflage der großen Koalition gegen eine breite Minderheit 	durchsetzen 	würde , würde eine solche Regierung wiederum nur ertragen , aber nicht als eigenes Projekt `` bewußt angenommen '' werden . 
durchsetzen_s8488_f0	Selbst der wird - auch ohne Gedankenspiele nach Schweriner Muster - innerparteilich schon schwer genug 	durchzusetzen 	sein . 
durchsetzen_s10389_f0	Irankeywordtag halte Terror nicht für den geeigneten Weg , seine Anschauungen 	durchzusetzen 	. 
durchsetzen_s10583_f0	So konnte sich Juppékeywordtag jetzt mit der Forderung einer zahlenmäßig kleinen und straff geführten Regierungsmannschaft bei dem Präsidenten 	durchsetzen 	, mit der er bei Chirac , der übrigens auch in diesem Fall seine Wahlkampfversprechen vergaß , im Mai nicht durchgedrungen war . 
durchsetzen_s10593_f0	Jüngere , politisch noch wenig erfahrene Minister bekamen es zu spüren , als die Anhänger Balladurs seit ihrer Rückkehr in die Nationalversammlung im September damit begannen , in der Haushaltsdebatte ihre eigenen Vorstellungen 	durchzusetzen 	. 
durchsetzen_s10930_f0	Die 52jährige Autorin konnte sich überraschend gegen den britisch-indischen Schriftsteller Salman Rushdie 	durchsetzen 	, der mit seinem Roman The Moor's Last Sigh ( Der letzte Seufzer des Mohren ) bei den Buchmachern als Favorit galt . 
durchsetzen_s11212_f0	Laut Duisenberg wird die Bundesbank wohl 	durchsetzen 	, daß die künftige Eurobank über dem deutschen System vergleichbare monetäre Instrumente ( Geldmengenziel , Mindestreserve ) verfügt . 
durchsetzen_s11877_f0	Washingtonkeywordtag versuche derzeit mit `` erpresserischen Mitteln '' 	durchzusetzen 	, daß die EU diese Bohnen ohne Kennzeichnungspflicht auf den Markt lasse . 
durchsetzen_s12615_f0	Als Leimrute präsentierten sie den 299 anwesenden Delegierten einen eigentlich von vornherein viel zu langen , geschwätzigen Leitantrag über SPD an sich , garniert mit ein paar provisorischen Forderungen , was mankeywordtag bei Koalitionsverhandlungen mit den Christdemokraten alles 	durchsetzen 	wolle , könne , müsse , solle . 
durchsetzen_s12745_f0	Die Fehler , die zum Scheitern der ersten Regierung Juppé geführt haben , sind ja nicht nur bei den Ministern und Staatssekretären zu suchen , die jetzt in die Wüste geschickt wurden , sondern auch bei Juppé selbst , derkeywordtag sich nicht 	durchzusetzen 	vermochte . 
durchsetzen_s12770_f0	Die Forderung nach einem - wenigstens partiellen - Ausgleich für den Lohnausfall konnten die Gewerkschaften hingegen nicht 	durchsetzen 	. 
durchsetzen_s12971_f0	Notfalls müßten Wirtschaftssanktionkeywordtag an den Außengrenzen von speziellen Einheiten 	durchgesetzt 	werden . 
durchsetzen_s13869_f0	Die EU-Behörde will damit erzwingen , daß die Bundesregierung die Pflicht zur Offenlegung der GmbH-Jahresabschlüsse - nach europäischer Vorgabe im deutschen Bilanzrichtliniengesetz festgeschrieben - strenger 	durchsetzt 	. 
durchsetzen_s14623_f0	Bundestagspräsidentin Rita Süssmuth äußert sich bereit , die Europäische Kommission zu eigenen Initiativen zu ermächtigen , damit sich gegenüber der Zusammenarbeit zwischen Regierungen mehr `` supranationale Interessenbestimmung '' 	durchsetzt 	. 
durchsetzen_s14639_f0	Angesichts der Schwierigkeiten , die verabredete Währungsunion zu schaffen , stellte Zellentin die Überlegung an , ob sich Frankreichkeywordtag mit Vorstellungen 	durchsetze 	, die auf ein `` Versailles der D-Mark '' hinausliefen , oder ob Deutschland mit der DM ein großdeutsches Währungsreich gründe , das sich nach Osten orientiere und Frankreich an die Peripherie dränge . 
durchsetzen_s14916_f0	Wir erinnern daran , daß auch der New Deal in den USA der 30er Jahre , der den Wohlfahrtsstaat begründete , gegen Widerstände in der Wirtschaft 	durchgesetzt 	werden mußte , obwohl er wirtschaftlicher Vernunft entsprach und eine Phase ökonomischer Prosperität einleitete . 
durchsetzen_s16398_f0	Daraus resultiert ein gewaltiges Regel- und Richtlinienwerk , entworfen und 	durchgesetzt 	von einer Administration , die vom Kulturministerium abhängt : das Nationale Kinozentrum ( CNC ) . 
durchsetzen_s18224_f0	Schließlich war es nicht zuletzt Rudolf Scharping , derkeywordtag vor der Bundestagswahl im vergangenen Jahr mit seiner Handschrift ein `` Regierungsprogramm 94 '' 	durchgesetzt 	hatte , in dem schon alles enthalten war , was sein geschaßter Wirtschaftssprecher heute vermißt . 
durchsetzen_s18225_f0	Die gewollte Provokation des regierenden Niedersachsen , `` SPD-Parteitagsbeschlüssekeywordtag niemals rein 	durchsetzen 	zu können '' ( und zu wollen ) , stieß und stößt in seiner Partei um so mehr auf Unwillen , als der Oberstratege der Union , Bundeskanzler Helmut Kohl , fleißig aus den Parteitagsbeschlüssen der SPD abzuschreiben scheint . 
durchsetzen_s18833_f0	Er teilt seinen Kollegen mit , wie sich die deutsche Seite die dauerhafte Einhaltung der Stabilitätskriterien in der 3. und letzten Stufe der Europäischen Wirtschafts- und Währungsunion ( EWWU ) vorstellt und wie siekeywordtag 	durchgesetzt 	werden sollen . 
durchsetzen_s18866_f0	ein zunächst angepeilter Komplettverkauf des Niederlassungsnetzes habe sich nicht 	durchsetzen 	lassen . 
durchsetzen_s19212_f0	Der kündigte in gewohnter Selbstüberschätzung zwar mal eben kurz die Koalition auf , sollte die FDP ihre Vorstellungen in der Gesundheitsreform nicht 	durchsetzen 	, das aber gehört zu den Möllemann-typischen Ausreißern , über die Gerhardt gelassen hinwegsehen kann , zumal derzeit fast alles willkommen ist , was die FDP öffentlich sicht- und hörbar macht . 
durchsetzen_s19395_f0	Bei den Verhandlungen über diese Richtlinien hätten die deutschen Vertreter bislang gemeinsam mit Großbritannien , Belgien , Frankreich und Japan 	durchgesetzt 	, daß Behälter zugelassen werden sollen , `` die einen Absturz nicht unbeschadet überstehen '' . 
durchsetzen_s19430_f0	Der Indianermissionsrat befürchtet , daß sich in den Gerichtsverfahren dann diejenigen 	durchsetzen 	, die sich Anwälte leisten könnten , und dies seien nicht die oft kleinen indianischen Völker . 
durchsetzen_s20373_f0	Der der katholischen Bischofskonferenz Brasiliens nahestehende Indianermissionsrat befürchtet , daß sich nach Änderung des Dekrets und Einführung des Widerspruchsrechts die Indianer in den dann folgenden juristischen Verfahren nicht 	durchsetzen 	können . 
durchsetzen_s20589_f0	Während seiner dreijährigen Amtszeit hat erkeywordtag nur einen kleinen Teil der versprochenen Reformen 	durchgesetzt 	. 
durchsetzen_s20779_f0	Ob sich daskeywordtag 	durchsetzen 	läßt ? 
durchsetzen_s20800_f0	Der Schweizer Andreas Gross und der Bayer Thomas Mayer , derkeywordtag in seinem Bundesland gegen den Willen der CSU auf plebiszitärem Wege mehr Plebiszite in den Kommunen 	durchgesetzt 	hat , plädierten heftig für eine solche `` Anreicherung '' ( Limbach ) der parlamentarischen Demokratie . 
durchsetzen_s22876_f0	Ziel sei es , so heißt es in der Gründungs-Präambel , `` eine aktive Gleichstellungs- und Antidiskriminierungspolitik in NRW 	durchzusetzen 	, die den emanzipatorischen Prozeß der Selbstorganisation von Migrantinnen , schwarzen Deutschen und anderen ethnischen Minderheiten unterstützt und die politische , wirtschaftliche , kulturelle und rechtliche Gleichstellung und Chancengleichheit befördert '' . 
durchsetzen_s23365_f0	Die USA bemühen sich in der Vollversammlung und im Sicherheitsrat der Vereinten Nationen ( UN ) darum , Strafmaßnahmenkeywordtag gegen Nigeria 	durchzusetzen 	. 
durchsetzen_s24619_f0	Von den traditionellen Parteien konnte sich nur die gemäßigt konservative `` Accion Popular '' von Expräsident Belaunde Terry in zwei größeren Städten - Chiclayo und Huancayo - 	durchsetzen 	. 
durchsetzen_s24950_f0	Auf diese Weise hofft der Hauptverband der Deutschen Bauindustrie das in Bonn schlummernde Entsendegesetz doch noch 	durchzusetzen 	, das den befürchteten drastischen Beschäftigungsabbau aufgrund der Niedriglohnkonkurrenz ausländischer Anbieter hierzulande verhindern soll . 
durchsetzen_s25152_f0	Ministerpräsident Alain Juppé , derkeywordtag höhere Steuern und Ausgabenkürzungen 	durchsetzen 	will , verknüpfte die Abstimmung mit der Vertrauensfrage . 
durchsetzen_s26165_f0	Die Externalisierungsstrategie ökologischer Kosten wurde durchaus nicht harmonisch und erst recht nicht friedlich 	durchgesetzt 	. 
durchsetzen_s26928_f0	Wenn Christoph Columbus sich nicht 	durchgesetzt 	hätte , wäre er nur Hafenkommandant von Sevilla geworden . 
durchsetzen_s27661_f0	Jungunternehmer-Verbandschef Wolfgang Mainz ( `` ökologische Innovationen können allein die Betriebe 	durchsetzen 	'' ) und Audi-Vorstand Andreas Schleef ( `` zunehmende Kundenorientierung der Industrie erfordert Arbeitseinsatz nach Bedarf '' ) durften dem mäßig interessierten Plenum ihre Thesen vortragen . 
durchsetzen_s27927_f0	Vom Parlament erhielt Juppékeywordtag eine Blankovollmacht , um seinen Kraftakt auf dem Verordnungswege 	durchsetzen 	zu können . 
durchsetzen_s28387_f0	Das entschied das Berliner Kammergericht , womit sich das Kartellamt in wesentlichen Punkten gegen den Urlaubsriesen TUI ( Hannover ) 	durchsetzte 	. 
durchsetzen_s28893_f0	Erkeywordtag brauchte das deutschnationale Lager , um sich an der FPÖ-Spitze 	durchzusetzen 	. 
durchsetzen_s28928_f0	Küng bevorzugte eindeutig die Frohbotschaft universaler Verständigung gegenüber der Drohbotschaft einer `` New World Order '' , diekeywordtag ihre Prinzipien notfalls mit weltpolizeilichen Mitteln 	durchsetzt 	. 
durchsetzen_s29387_f0	Auf der Grundlage der ökonomisch-politischen Verhältnisse ihres postfeudalen Landes erschien ihr nur eine einheitliche , zentralistische politische Führung in der Lage zu sein , das nationale Aufbauprogramm Chinas erfolgreich 	durchzusetzen 	. 
durchsetzen_s29410_f0	Andererseits hatte sich Maokeywordtag auch nicht gescheut , seine Politik der Einheit mit Hilfe der Massen gegen Teile der Partei 	durchzusetzen 	( Kulturrevolution ) , um die `` korrekte Massenlinie '' zu wahren . 
durchsetzen_s29479_f0	Dengs Antwort , mit der erkeywordtag sich in der Parteiführung 	durchsetzte 	, ist bekannt , wenn auch meistens falsch erklärt . 
durchsetzen_s29505_f0	Die Reformen haben mittlerweile fast alle Bedingungen erzeugt , im Land die Marktwirtschaft 	durchzusetzen 	. 
durchsetzen_s29989_f0	Schon im Frühjahr ließ erkeywordtag an seiner Entschlossenheit keinen Zweifel , seine Haushaltspolitik um `` jeden Preis '' 	durchzusetzen 	. 
durchsetzen_s30552_f0	Präsident Jacques Chiracs Regierungschef hat damit freie Hand , die drastischen Einschnitte ohne weitere parlamentarische Debatte auf dem Verordnungswege 	durchzusetzen 	. 
durchsetzen_s30721_f0	Allerdings sei unklar , ob Lafontainekeywordtag die Integrationskraft besitze , um nötige soziale und ökologische Reformen in der SPD 	durchzusetzen 	. 
durchsetzen_s30761_f0	Fünfzig Jahre waren nötig , bis sich in der deutschen Rechtsprechung die Erkenntnis 	durchgesetzt 	hat , daß NS-Richter für ihre Schuld zur Verantwortung hätten gezogen werden müssen . 
durchsetzen_s32207_f0	Ist die Rekonstruktion der Bauakademie erst einmal 	durchgesetzt 	, dürfte der Augentrug Stadtschloß nicht mehr inopportun erscheinen . 
durchsetzen_s32432_f0	Und wie bei allen asymmetrischen Konflikten ist die Gefahr groß , daß die überlegene Partei mit Hilfe physischer und struktureller Gewalt ihre Privilegien 	durchsetzt 	. 
durchsetzen_s32516_f0	Luganvillekeywordtag ist dabei lethargisch geblieben , 	durchsetzt 	mit kleinen Grill-Bars und vietnamesischen Drugstores , die bis zur Spinnwebgrenze vollgestopft sind mit grellen Sportartikeln , mit Knöpfen , Töpfen , Kannen , Blecheimern , verstaubten Stoffballen , Plastikblumen , Zahnpasta , Putzlappen und Plastiklatschen . 
durchsetzen_s32951_f0	Aber die Staatskonzerne haben so keine Chancen , sich gegen die Kollektivbetriebe 	durchzusetzen 	, die fast 69 Prozent der Unternehmen stellen . 
durchsetzen_s32988_f0	Keiner wagt in Peking eine Prognose , welches Modell sich 	durchsetzen 	wird . 
durchsetzen_s33705_f0	`` Das schließt den Einsatz von Kampfflugzeugen ( ECR-Tornados ) aus '' , heißt es dazu in einer ergänzenden Formulierung , diekeywordtag der neue Parteichef Oskar Lafontaine 	durchgesetzt 	hat . 
durchsetzen_s33893_f0	Die Gläubigen könnten den Eindruck gewinnen , die Kirche wolle nur ihren Machtanspruch 	durchsetzen 	. 
durchsetzen_s33905_f0	Das sei Zivilcourage und nicht der Versuch , Machtansprüchekeywordtag 	durchzusetzen 	. 
durchsetzen_s34784_f0	In einem weltweit geführten Kampf um Märkte und Ressourcen können sich nur die Unternehmen 	durchsetzen 	, die über innovative Produkte , aggressive Marktstrategien und niedrige Kosten verfügen . 
durchsetzen_s35005_f0	Die gegenwärtig zu verzeichnenden enormen Produktivitätszuwächse als Ergebnis forcierter Rationalisierung und Globalisierung der Fertigung und der Restrukturierung von Unternehmen , die es möglich machen , mit abnehmenden Arbeitszeitvolumina und auch mit abnehmendem Ressourcenaufwand zunehmende Mengen an Waren und Dienstleistungen zu erzeugen , könnten die Grundlage für wachsenden Wohlstand und zunehmende Lebensqualität sein , und das nicht nur im Inland , wenn politisch dafür Sorge getragen würde , daß sich nicht nur die betriebswirtschaftliche Rationalität 	durchsetzt 	, die die Produktivitätszuwächse hervorbringt , sondern gleichermaßen eine gesamtwirtschaftliche , die sie gesellschaftlich nutzt . 
durchsetzen_s35006_f0	Wenn mit sinkendem Aufwand an Arbeit und Ressourcen eine zunehmende Menge an Waren und Dienstleistungen erzeugt werden kann , müssen Gesellschaften nicht ärmer werden , sondern sie können reicher werden , vorausgesetzt , daß auf der Basis der Produktivitätszuwächse wachsende Einnahmen aus abhängiger Beschäftigung und wachsende Einnahmen der öffentlichen Hand 	durchgesetzt 	werden . 
durchsetzen_s35007_f0	Wenn jedoch , wiekeywordtag eskeywordtag neoliberale Ideologie und Politik mit fundamentalistischer Erbarmungslosigkeit propagiert und durchzusetzen versucht , Produktivitätszuwächse nur die Gewinne überproportional steigen lassen und obendrein Umverteilungen zu Lasten von Einkommen aus abhängiger Beschäftigung und von Einnahmen der öffentlichen Hand und zu Gunsten von Einkommen aus Gewinnen und Vermögen zu verzeichnen sind , muß die Marktwirtschaft aus dem Ruder laufen . 
durchsetzen_s35015_f0	Es bedarf demokratischer Regulierung der Verteilung , um auch zwischenstaatlich Umverteilungen von Einkommen und Ressourcen 	durchzusetzen 	, die die tödlichen Ungleichgewichte in der Einkommensverteilung zwischen Industrie- und Entwicklungsländern einerseits und zwischen westlichen und östlichen Industrieländern andererseits verschwinden lassen . 
durchsetzen_s35043_f0	Keine transnationale Unternehmung , keine internationale Finanzinstitution und kein sonstiger Akteur der Weltwirtschaft könnte eine Wirtschaftsmacht wie die Bundesrepublik Deutschland , geschweige denn , wie die Europäische Union daran hindern - die ungebrochene Respektierung demokratischer Strukturen , demokratischer Prozesse und demokratischer Entscheidungen vorausgesetzt - notwendige und wünschenswerte Regulierungen des internationalen Handels- und Zahlungsverkehrs und der nationalen marktwirtschaftlichen Entwicklung im Interesse der genannten politischen , ökonomischen , sozialen und ökologischen Ziele von Vollbeschäftigung , sozialer Sicherheit , Umweltschutz und politischer Stabilität 	durchzusetzen 	. 
durchsetzen_s35338_f0	Nun war doch der Moment , weltweit geltende Regeln 	durchzusetzen 	, um in Zukunft , so Jackson , `` jenen den Krieg zu vergällen , in deren Händen sich die Macht und das Schicksal ganzer Völker befinden '' . 
durchsetzen_s35849_f0	Offenbar habe sich Frau Merkel nicht gegen die Interessenpolitik von Wirtschaftsminister Günter Rexrodt ( FDP ) 	durchsetzen 	können . 
durchsetzen_s35850_f0	Er halte es für notwendig , sagte Flasbarth , das hohe Niveau der in Deutschland geltenden Sicherheitsstandards auch international 	durchzusetzen 	. 
durchsetzen_s37096_f0	Der HDI konnte sich zuletzt gegen die Konkurrenz von Axa Colonia 	durchsetzen 	. 
durchsetzen_s37104_f0	Hannes Walther , der Geschäftsführer der staatlichen Manufaktur , kündigt zur Messe Ambiente Aufschläge von im Schnitt 2,5 Prozent an und gibt sich zuversichtlich , diesekeywordtag 	durchsetzen 	zu können . 
durchsetzen_s37918_f0	Bereits am Donnerstag hatte Ex-Aufsichtsratschef Wilhelm Scheider ausgesagt , daß Hennemannkeywordtag es immer wieder geschafft habe , in Verhandlungen mit der Treuhand seine Wünsche 	durchzusetzen 	. 
durchsetzen_s38041_f0	Heckertkeywordtag habe sich auch gegen deutsche Wettbewerber 	durchgesetzt 	, sagte Kübler . 
durchsetzen_s38604_f0	Auch diese Erkenntnis sollte sich beim Europäischen Rat in Amsterdam 	durchsetzen 	- ohne daß man deshalb den Euro per Regierungseinfluß auf seine Hüter von Anfang an schwächen muß . 
