einfuehren_s652_f1	Vor kurzem hat die Treuhand deshalb nach langem Hin und Her die zwölfjährige Pacht 	eingeführt 	und dafür die Bodenverwaltungs- und -verwertungsgesellschaft ( BVVG ) gegründet , an der neben der Anstalt drei Agrarfinanziers ( Landwirtschaftliche Rentenbank , DSL-Bank , Landeskreditbank Baden-Württemberg ) je ein Viertel des Kapitals halten . 
einfuehren_s1756_f1	Wie bei der Gesundheitsreform müßten auch hier im `` etwas üppig '' gewordenen sozialen Sicherungssystem `` Elemente der Selbstbeteiligung '' 	eingeführt 	werden . 
einfuehren_s1759_f1	Warum um Himmels willen soll es unzumutbar sein , zu sagen , daß eben im Krankheitsfall dann eine Eigenbeteiligung des Versicherten 	eingeführt 	werden soll in einer Form , daß er sich einen Tag Urlaub anrechnen lassen soll ? '' 
einfuehren_s2072_f1	Japankeywordtag will im Herbst eine Tonne Plutonium aus Frankreich 	einführen 	. 
einfuehren_s3554_f1	Mit wieviel Blindheit muß eigentlich eine Regierung geschlagen sein , diekeywordtag eine Neuerung wie den Punkteführerschein ausgerechnet zum 1. Juli 	einführt 	? 
einfuehren_s3660_f1	Als zweite der früheren Sowjetrepubliken wird Lettlandkeywordtag nach Estland eine eigene Währung 	einführen 	und den Rubel abschaffen . 
einfuehren_s3683_f1	Für Mieterhöhungen außer bei Neubauwohnungen soll eine Kappungsgrenze von 15 Prozent in drei Jahren 	eingeführt 	werden . 
einfuehren_s3685_f1	Ferner solle eine Mietüberhöhungsgrenze von 20 Prozent , in Regionen mit erhöhtem Wohnbedarf von zehn Prozent über der ortsüblichen Vergleichsmiete 	eingeführt 	, die Maklergebühren sollten auf eine Monatsmiete begrenzt werden . 
einfuehren_s4811_f1	Denn werkeywordtag ausschließlich den Haushaltsbedarf 	einführt 	, muß nur die Mehrwertsteuer entrichten . 
einfuehren_s5656_f1	Dazu müsse gehören , neue Umweltsteuern wie zum Beispiel die CO2-Energiesteuer 	einzuführen 	und steuerliche Begünstigungen für umweltbelastende Aktivitäten abzubauen . 
einfuehren_s7285_f1	Daskeywordtag Mittelkeywordtag der Off-Stimme , 	eingeführt 	im Hollywood der Film-noir-Ära , ist im Kino eher verpönt , es gilt als unfilmisch , redundant , als Zeichen von narrativer Unbeholfenheit . 
einfuehren_s8121_f1	Das Präsidentenamt war mit der am Sonntag in Kraft getretenen neuen Verfassung wieder 	eingeführt 	worden , nachdem es Anfang 1992 nach dem Sturz des ersten Präsidenten Swiad Gamsachurdia abgeschafft worden war . 
einfuehren_s8738_f1	Die Wehrpflicht würde er gerne wieder 	eingeführt 	sehen : 
einfuehren_s11027_f3	Am Nachmittag ( Ortszeit ) war Werleighkeywordtag als neue Ministerpräsidentin von Aristide in ihr Amt 	eingeführt 	worden . 
einfuehren_s11113_f1	Ermittler des Bundeskriminalamts ( BKA ) in Wiesbaden haben 1992 mehrere Tonnen sogenannter weicher Drogen wie Haschisch und Marihuana in die Niederlande 	eingeführt 	, um einer internationalen Drogenmafia auf die Spur zu kommen . 
einfuehren_s11689_f1	Wurde es anfangs als Vollzuschuß gewährt , wurde schon bald ein Teildarlehen 	eingeführt 	, welches dann später zum Volldarlehen anwuchs . 
einfuehren_s11711_f1	Jetzt soll dieser soziale Numerus clausus wieder 	eingeführt 	werden . 
einfuehren_s11714_f1	Nachdem die Bundesregierung selbst kurz vor der Bundestagswahl im letzten Jahr die Förderung von Meisterkursen aus dem Arbeitsförderungsgesetz ( AFG ) gestrichen hatte , will sie nun das `` Meister-Bafög '' 	einführen 	. 
einfuehren_s11719_f1	Der Versuch , über den Weg des `` Meister-Bafög '' die Verzinsung der Bafög-Darlehen für alle schulischen und beruflichen Ausbildungswege 	einzuführen 	, wurde in der vergangenen Woche zu Recht vom Bundesrat vereitelt . 
einfuehren_s16713_f1	Hundertjährigekeywordtag Pinienkeywordtag , 	eingeführt 	von der australischen Norfolkinsel , säumen die Straßen am Hafen , vor dessen Eingang die Vogelinsel Griffiths Island wie ein Wellenbrecher liegt . 
einfuehren_s19418_f1	Mit dem neuen Dekret wird nach Angaben von Cimi , der der katholischen Bischofskonferenz Brasiliens nahesteht , sowie der in Göttingen ansässigen Gesellschaft für bedrohte Völker ( GfbV ) ein Widerspruchsrecht bei der Ausweisung indianischer Gebiete 	eingeführt 	. 
einfuehren_s19763_f1	Falls siekeywordtag nicht 	eingeführt 	werden , seien die Perspektiven für Europa `` düster '' , sagte er der Berliner Morgenpost . 
einfuehren_s19959_f1	Es soll ein echter Anreiz für Einstellungen geschaffen werden , indem Ausgleichsabgaben nach dem Vorbild der Umweltsteuer 	eingeführt 	werden . 
einfuehren_s20363_f1	Mit dem neuen Gesetz werde ein Widerspruchsrecht bei der Ausweisung indianischer Gebiete 	eingeführt 	, teilten Cimi und die Gesellschaft für bedrohte Völker ( GfbV ) mit . 
einfuehren_s20920_f1	Ikimi sagte , es gebe Pläne , die Demokratie bis 1998 wieder 	einzuführen 	. 
einfuehren_s21391_f1	Studiengebührenkeywordtag seien nicht Sache der Rektoren , sondern könnten nur von den Ländern 	eingeführt 	werden . 
einfuehren_s21877_f1	Dann wollen die Weltparlamentarier separat und gleich zweimal zu ihrem gut halbstündigen Liebeskonzil sich treffen , 	eingeführt 	vom Meister . 
einfuehren_s23367_f1	Die amerikanische UN-Botschafterin Madeleine Albright erörterte am Montag in New York mit führenden Mitgliedern der beiden Gremien , die nigerianische Militärregierung in einer Resolution zu verurteilen und UN-Sanktionenkeywordtag 	einzuführen 	. 
einfuehren_s25110_f1	Ruggiero sieht allerdings derzeit nicht die Gefahr , daß wieder Handelsschrankenkeywordtag 	eingeführt 	werden . 
einfuehren_s28613_f1	Nicht nur die Konkurrenten aus der Branche könnten versucht sein , auf kaltem Wege die 37-Stunden-Woche wieder 	einzuführen 	. 
einfuehren_s28954_f2	Denn werkeywordtag Religionkeywordtag in die Debatte 	einführt 	, führt zunächst Differenzen ein , die dann mühsam wieder überbrückt werden müssen . 
einfuehren_s29368_f1	Der Erfolg macht zeitweilig vergessen , daß Dengkeywordtag die fundamentalen Neuerungen nur 	eingeführt 	hat , um die Macht der Partei zu bewahren , die auch seine Macht war ... 
einfuehren_s29436_f1	In der Landwirtschaft bestand daher die erste Reform darin , das Pachtsystem 	einzuführen 	. 
einfuehren_s29437_f1	In der Industrie wurde das System der Besteuerung 	eingeführt 	. 
einfuehren_s30150_f1	Bundesweitkeywordtag 	eingeführt 	wird die Luxus-Auskunft erst nach dem kommenden April . 
einfuehren_s30555_f1	Dazu wird eine neue `` Zusatzabgabe zur Abzahlung der Sozialversicherungsschulden '' ( RDS ) 	eingeführt 	, die in Höhe von 0,5 Prozent von allen Arbeitseinkünften , Kapitalerträgen sowie sozialen Leistungen wie Renten , Arbeitslosen- oder Krankengeld erhoben wird . 
einfuehren_s30581_f2	Die Todesstrafe könnte in Deutschland selbst mit einer Grundgesetzänderung nicht mehr 	eingeführt 	werden , weil die Änderung des Artikels 102 ( `` Die Todesstrafe ist abgeschafft '' ) ein Verstoß gegen die Menschenwürde und gegen das Grundrecht auf Leben wäre . 
einfuehren_s32699_f1	Waldkirch im Schwarzwald will als erster Ferienort Deutschlands eine `` Naturtaxe '' 	einführen 	. 
einfuehren_s32918_f1	Seit 1990 die Reisefreiheit innerhalb Chinas 	eingeführt 	wurde , verwandelt sich Liu jedes Jahr für zwei Monate in einen Wanderarbeiter . 
einfuehren_s32995_f1	Eine ernsthafte Absicht , Renten- und Krankenkassen für die Bauern 	einzuführen 	, gibt es bislang nicht . 
einfuehren_s33883_f1	Es geht wieder einmal um den umstrittenen Plan , in Brandenburg ein Pflichtfach Lebenskunde , Ethik , Religionen ( LER ) 	einzuführen 	. 
einfuehren_s34722_f1	Drei Schnitte , und die drei Personen : der Täter , der Psychiater Professor Dr. Ernst Schultze , der Stenograf , sind 	eingeführt 	, der Raum ist grob definiert . 
einfuehren_s37396_f1		Eingeführt 	wird das Gemeinschaftsgeld nach dem von der Dresdner weiter für am wahrscheinlichsten gehaltenen Szenario pünktlich Anfang 1999 in sechs bis acht Ländern , die in diesem Jahr die Konvergenzkriterien `` weitgehend '' erfüllen dürften ( Frankreich , Deutschland , Benelux-Staaten , Österreich , vermutlich Irland und Finnland ) . 
einfuehren_s38724_f1	Konsens erzielten die 16 Ressortchefs nur darüber , zu `` überprüfen '' , ob der Euro in der öffentlichen Verwaltung bundesweit bereits vor dem vom Bonner Finanzministerium angepeilten Datum 1. Januar 2002 	eingeführt 	werden kann . 
einfuehren_s38733_f1	Auch der thüringische Finanzminister Andreas Trautvetter ( CDU ) fragte : `` Wie soll die öffentliche Hand Vertrauen in den Euro wecken , wenn sie ihnkeywordtag selbst als letzter 	einführt 	? '' 
einfuehren_s38742_f1	So möchte der Wiesbadener Kassenwart Starzacher gerne statt des herkömmlichen kameralistischen Rechnungswesens die doppelte Buchführung und ein modernes Controlling 	einführen 	. 
einfuehren_s39014_f1	Vor fast genau fünf Jahren haben die privaten Banken ein Verfahren 	eingeführt 	, um Streitigkeiten zwischen Kunden und Kreditinstituten außergerichtlich zu schlichten . 
einfuehren_s39821_f1	Ferner würden siekeywordtag einen in der präzisen Höhe mit Unternehmen und Gewerkschaften abgesprochenen `` nationalen Mindestlohn '' 	einführen 	, um das Los der am schlechtesten Verdienenden zu bessern . 
