engagieren_s517_f2	Deutschlandkeywordtag darf sich nie wieder kämpfend außerhalb seiner Grenzen und der seines Bündnisgebietes 	engagieren 	. 
engagieren_s1125_f2	Die politische Instabilität habe zudem ausländische Investoren davon abgehalten , sich in Israel zu engagieren . 
engagieren_s1262_f2	An dem Treffen nahm auch Tiny Rowland teil , Chef des britischen Großkonzerns Lonrho , derkeywordtag sich stark in Mosambik und Simbabwe 	engagiert 	hat . 
engagieren_s1723_f2	Die restlichen 2000 Arbeitsplätze seien nur zu halten , wenn der Staat sich in der technologischen Umrüstung 	engagiere 	, sagt der geländereiche Investor . 
engagieren_s3267_f2	Erst dann könnte die Weltbank branchenbezogene Anpassungskredite auf der Grundlage staatlicher Bürgschaften gewähren und die westliche Industrie sich stärker 	engagieren 	. 
engagieren_s7193_f1	Ulf Berg , Manager der ABB Kraftwerke , diekeywordtag als Generalunternehmer 	engagiert 	ist , sieht in der 380-MW-Anlage `` das effizienteste und umweltverträglichste Heizkraftwerk Europas '' . 
engagieren_s11380_f1	uns verband unsere Hoffnung , unsere Bereitschaft , unskeywordtag für die gemeinsame Sache zu engagieren , unsere Solidarität sowie unser Bemühen , den anderen zu verstehen . 
engagieren_s11659_f2	Wir werden im kommenden Jahr versuchen wieder neuen Schwung zu finden und appellieren an alle Studierenden , sich mehr mit Hochschulpolitik auseinanderzusetzen und vor allem sich aktiv zu engagieren . 
engagieren_s12205_f2	Um dem organisierten Verbrechen auf die Spur zu kommen , haben die niederländischen Polizeibehörden sich selbst im Drogenhandel 	engagiert 	. 
engagieren_s14995_f1	Sogedimkeywordtag bleibe innerhalb eines Jahres mit mindestens einem Viertel bei Adidas 	engagiert 	. 
engagieren_s16941_f2	Olda Kokoschka 	engagiert 	sich für die von ihr in Vevey gegründete Kokoschka-Stiftung und läßt es sich nicht nehmen , selbst ergänzende Werke weltweit ausfindig zu machen . 
engagieren_s17254_f2	Menschen , diekeywordtag sich für eine friedliche Demokratie 	engagieren 	, werden verhaftet oder verschwinden einfach . 
engagieren_s20798_f2	Die eher kritischen Töne kamen dabei von den weniger namhaften Tagungsteilnehmern , darunter eine stattliche Schar von Menschen , diekeywordtag sich in Bürgerinitiativen 	engagieren 	. 
engagieren_s22351_f2	Die nämlichen Sänger , diekeywordtag in Zürich , St. Gallen oder St. Pölten unschwer 	engagiert 	werden könnten , ständen für Stuttgart , Hamburg oder Köln nicht mehr zur Verfügung . 
engagieren_s22809_f2	Die Bank 	engagiert 	sich auch beim Telekommunikationssystem Qinghai PTA . 
engagieren_s25133_f1	Diesekeywordtag seien zwar sehr darauf bedacht , sich einen höheren Anteil am Haushalt zu sichern , aber sehr viel weniger 	engagiert 	, wenn es darum gehe , mit den Geldern einen sinnvollen Effekt zu erzielen . 
engagieren_s25341_f2	Wie sich all jene fühlen , diekeywordtag sich in den Ortsvereinen und in der Kommunalpolitik 	engagieren 	und drei , vier Abende in der Woche und an Wochenenden für die SPD unterwegs sind . 
engagieren_s25345_f2	Hier zeigen 130 der insgesamt 12 000 SPD-Ortsvereine , wokeywordtag und wie siekeywordtag sich 	engagieren 	- in Betrieben und beim Umweltschutz , für Altenpflege oder Gefangenenhilfe . 
engagieren_s32966_f2	Auch die Friedrich-Ebert-Stiftung hat sich mit ihrem Büro in Peking 	engagiert 	, gibt Rat , wo er gesucht wird und macht chinesische Experten mit dem deutschen Modell vertraut . 
engagieren_s37230_f2	Neben dem Fußball betrieb das Freizeitunternehmen 40 Pubs und 	engagierte 	sich im dahinsiechenden Immobilienmarkt . 
engagieren_s39095_f2	Hinter den Hannoveranern steht die Westdeutsche Landesbank , diekeywordtag auch bei TUI und LTU 	engagiert 	ist . 
engagieren_s39535_f1	Der Konzern ist im Stromgeschäft in Mittelböhmen 	engagiert 	und am Bau eines Steinkohle-Kraftwerks für Skoda dabei . 
engagieren_s39856_f2	Bestimmte Investoren , diekeywordtag sich aus Steuerspargründen bislang in Immobilien 	engagiert 	hätten , könnten ausbleiben . 
engagieren_s39904_f2	International ausgerichtete Sondervermögen zogen nämlich auf 8,7 Milliarden Mark an , während bei den Aktienfonds , diekeywordtag sich schwerpunktmäßig in Deutschland 	engagieren 	, lediglich gut 200 Millionen Mark an neuem Geld hinzukamen . 
