Entscheidung_s531_f2	Die Entscheidung über einen militärischen Einsatz welcher Art auch immer muß demokratisch so organisiert sein , daß am Ende eine breitgetragene Verantwortung steht , die die jeweilige 	Entscheidung 	nach innen wie außen überzeugend und nachvollziehbar macht . 
Entscheidung_s556_f1	Die Rechtsaufsicht hat der Bundesinnenminister - eine vielfach für bedenklich gehaltene Konstruktion , weil sie der Unabhängigkeit der Mitglieder zuwiderläuft , wenn 	Entscheidungen 	- wie geschehen - von Bonn als rechtswidrig bewertet werden . 
Entscheidung_s566_f1	Anfang dieses Jahres hat der Bundesrechnungshof die Parteienvermögens-Kommission geprüft und dem Sekretariat eigenmächtige 	Entscheidungen 	vorgeworfenkeywordtag , zu denen es rechtlich nicht ermächtigt gewesen sei . 
Entscheidung_s989_f1	Da dieskeywordtag eine nicht wieder zu korrigierende 	Entscheidung 	istkeywordtag ( Hessisches Finanzgericht AZ : 2 K 3188 / 90 ) , heißt es bis 1998 , jährlich zu überdenken , wann der Zeitpunkt dafür gekommen ist , vom alten Recht Abschied zu nehmen . 
Entscheidung_s1305_f1	Die 	Entscheidung 	für den Bundeswehreinsatz hatte Außenminister Klaus Kinkel ( FDP ) zusammen mit Verteidigungsminister Volker Rühe ( CDU ) in der Nacht zum Samstag getroffenkeywordtag . 
Entscheidung_s1309_f1	Der außenpolitische Sprecher der SPD-Fraktion , Karsten Voigt , begrüßte die 	Entscheidung 	und sagte , dieser humanitäre Dienst der Bundeswehr werde über alle Parteigrenzen hinaus hoffentlich von großer Zustimmung getragen werden . 
Entscheidung_s1993_f1	Die 	Entscheidung 	sei bereits am vergangenen Freitag bei einem Treffen in Gruda , einer kleinen kroatischen Stadt bei Dubrovnik , gefallenkeywordtag , das der Führer der Kroatischen Demokratischen Gemeinschaft ( HDZ ) in Bosnien , Mate Boban , einberufen hatte . 
Entscheidung_s2588_f1	Sie haben sich lange gegen eine Rolle der irischen Republikregierung bei 	Entscheidungen 	über die Zukunft der Provinz gewehrt . 
Entscheidung_s2930_f1	Diese überraschende 	Entscheidung 	eines NATO-Landes , für die in erster Linie der christdemokratische Verteidigungsminister Leo Delcroix verantwortlich zeichnet , hat eine ebenfalls sehr ungebräuchliche Protestreaktion der belgischen Heeresleitung hervorgerufen und ist auch in NATO-Kreisen nicht gerade auf Gegenliebe gestoßen . 
Entscheidung_s2945_f1	Inzwischen hat die 	Entscheidung 	zur drastischen Umstrukturierung der belgischen Streitkräfte den Zorn der Heeresleitung ausgelöst . 
Entscheidung_s2951_f1	Im Gegensatz zum Protest von militärischer Seite ist die 	Entscheidung 	der Regierung in Brüssel bei keiner der politischen Parteien auf große prinzipielle Einwände gestoßen . 
Entscheidung_s3112_f1	`` Erforderlich sind präzisere Konzepte , bessere Mechanismen zur Umsetzung von Hilfe , flexible Institutionen sowie leistungsfähigere Verfahren für 	Entscheidung 	und Koordination auf nationaler und internationaler Ebene '' , heißt es in einer Analyse zum Münchener Wirtschaftsgipfel , in dem das Institut eine `` wichtige Durchgangsstation '' im Prozeß der Konzipierung und Realisierung westlicher Hilfe sieht . 
Entscheidung_s3122_f1	Rifkind machte Rühe gegenüber deutlich , daß London die prinzipielle 	Entscheidung 	der Deutschen aus militärischen ebenso wie aus finanziellen und industriellen Gründen für verfehlt hält . 
Entscheidung_s3334_f1	Die 	Entscheidung 	der Regierung , die Herausforderung der `` Routiers '' , wie die Fernfahrer in Frankreich heißen , mit einem Kraftakt zu beenden , war zumkeywordtag Schlußkeywordtag eineskeywordtag langenkeywordtag Wochenendeskeywordtag gefallenkeywordtag , in dessen Verlauf das Land immer mehr in Agonie zu verfallen schien . 
Entscheidung_s3358_f1	So war denn wohl am Sonntag abend im Hôtel Matignon die 	Entscheidung 	gefallenkeywordtag , die die einen wie Innenminister Paul Quilès schon von Anfang an befürwortet , andere aber wie etwa Marc Blondel von der Gewerkschaft FO als `` größten Fehler überhaupt '' verworfen hatten - die gewaltsame Räumung von Barrikaden . 
Entscheidung_s3600_f1	Dabei könne selbstverständlich auch festgelegt werden , daß vor einer 	Entscheidung 	über einen Kampfeinsatz das Parlament angemessen zu beteiligen sei . 
Entscheidung_s4021_f1		Entscheidung 	über 30-Stunden-Woche aufgeschoben / 
Entscheidung_s4166_f1	Die polnischen Wähler haben die 	Entscheidung 	über den neuen Staatspräsidenten auf eine Stichwahl zwischen Amtsinhaber Lech Walesa und seinem exkommunistischen Herausforderer Aleksander Kwasniewski zugespitzt . 
Entscheidung_s4178_f1	Die katholische Kirche hatte am Wahltag mit deutlichen Stellungnahmen gegen Kwasniewski in die 	Entscheidung 	eingegriffen . 
Entscheidung_s4326_f1	Er rechne mit einer 	Entscheidung 	bis Ende der Woche . 
Entscheidung_s4418_f1	Gegen diese 	Entscheidung 	hatte die Partei Einspruch eingelegt . 
Entscheidung_s4421_f1	Die Wahlkommission kündigte an , sie werde der 	Entscheidung 	des Gerichtes entsprechen . 
Entscheidung_s4989_f1	Diese 	Entscheidung 	hat sich bewährt , auf diese Weise wurde der Korpsgeist weitestgehend ausgeschaltet . 
Entscheidung_s5096_f1	Der ursprüngliche Termin , 24. Oktober , warkeywordtag wegen der Sonnenfinsternis verschoben worden - im abergläubischen Burma eine plausible 	Entscheidung 	, die aber auch der Ratlosigkeit über die Zukunft Burmas entspricht . 
Entscheidung_s5107_f1	Erstmals kündigte das Gericht den Termin , an dem die 	Entscheidung 	bekanntgegeben wird , öffentlich an . 
Entscheidung_s5114_f1	Die 	Entscheidung 	löste eine Sondersitzung des Bundestages und eine öffentliche Kontroverse aus , in deren Verlauf die drei Verfassungsrichter teilweise persönlich angegriffen wurden . 
Entscheidung_s5115_f1	Da noch vier weitere Fälle zurkeywordtag 	Entscheidung 	anstandenkeywordtag , hielt es der Berichterstatter , Verfassungsrichter Dieter Grimm , für angezeigt , die Verfassungsbeschwerden vom gesamten Ersten Senat entscheiden zu lassen . 
Entscheidung_s5121_f1	In den zur 	Entscheidung 	anstehendenkeywordtag Fällenkeywordtag geht es um folgenden Sachverhalt : 
Entscheidung_s5577_f1	Die 	Entscheidung 	über den richtigen Kommentar können Siekeywordtag höchstwahrscheinlich kurz nach 20 Uhr treffenkeywordtag , sobald die Agenturen die ersten Hochrechnungen übermitteln . 
Entscheidung_s5585_f1	Mit ihrerkeywordtag 	Entscheidung 	gegen die 30-Stunden-Woche haben die Delegierten des Gewerkschaftstages der IG Metall Augenmaß bewiesen . 
Entscheidung_s5596_f1	Mit ihrerkeywordtag 	Entscheidung 	haben sie den grundsätzlichen Erfolg von Arbeitszeitverkürzung nicht geschmälert . 
Entscheidung_s5637_f1	Zu klaren 	Entscheidungen 	gehört dann auch , gegen orthodoxe Extremisten vorzugehen , auch wenn sie Juden sind . 
Entscheidung_s6082_f1	Die Bundesrichter bestätigten mit ihrem Grundsatzurteil jedoch die Ablehnung eines früheren DDR-Richters , der gegen die 	Entscheidung 	des Richterwahlausschusses von Chemnitz geklagt hatte . 
Entscheidung_s6088_f1	Der Anwalt des Klägers hatte in der mündlichen Verhandlung dagegen gefordert , die 	Entscheidungen 	der Ausschüsse gerichtlich voll nachzuprüfen . 
Entscheidung_s6172_f1	Im Hintergrund der jüngstenkeywordtag 	Entscheidung 	stehen offenbar die Gehaltsforderungen von Mortier , die in Teilen der Öffentlichkeit auf heftige Kritik gestoßen waren . 
Entscheidung_s6252_f1	Die 	Entscheidung 	über den künftigen Präsidenten Polens wird voraussichtlich erst am 19. November in einer Stichwahl fallenkeywordtag , da offenbar keiner der beiden Favoriten beim ersten Wahlgang die notwendige Mehrheit von mehr als 50 Prozent der Stimmen erreicht hat . 
Entscheidung_s6451_f1	Die neun von der 	Entscheidung 	betroffenen Präparate sind : Femovan , Lovelle , Marvelon , Minulet , Biviol , Oviol , Cyclosa , Cetenyl und Dimirel . 
Entscheidung_s6557_f1	Die Bonner Koalitionsparteien CDU / CSU und FDP stehenkeywordtag nach Angaben von Bundeswirtschaftsminister Günter Rexrodt ( FDP ) dicht vorkeywordtag einer 	Entscheidung 	über die geplante Änderung des Ladenschlußgesetzes . 
Entscheidung_s6826_f1	Kohl , verlautete aus der Pelzbranche , habe Verständnis für die Sorgen der Betroffenen geäußert und gesagt , mankeywordtag könne `` als Stadtmensch nicht einfach 	Entscheidungen 	treffenkeywordtag , die anderen , die in und von der Natur leben , Schaden bringen würden '' . 
Entscheidung_s7455_f1	Jede 	Entscheidung 	wird Risiken bergen . 
Entscheidung_s7549_f1	Bereits bei der 	Entscheidung 	für ein gemeinsames Bundesland Berlin-Brandenburg wurde erkennbar , daß sich der Kern der CDU mit den neuen Realitäten nicht abfinden wird . 
Entscheidung_s7578_f1	17. das gewählte Abgeordnetenhaus kann in der gegenwärtigen Situation sehr viel stärker als bisher zur Stätte ernsthafter Diskussion und wirklicher 	Entscheidung 	werden . 
Entscheidung_s7590_f1	Es ist ein Gebot der parlamentarischen Demokratie , die 	Entscheidung 	der Wähler anzuerkennen und in die Opposition zu gehen . 
Entscheidung_s7605_f1	Daß die Chinesen die zeitliche Abfolge der zwei Besuche als bewußtekeywordtag 	Entscheidung 	Bonnskeywordtag wahrnehmen , gibt man selbst auf deutscher Seite zu . 
Entscheidung_s7682_f1	Beide Seiten haben sich dazu verstanden , die 	Entscheidung 	bis zum Anfang des nächsten Jahres aufzuschiebenkeywordtag . 
Entscheidung_s7815_f1	Da jedoch keiner der Bewerber im ersten Wahlgang die absolute Mehrheit erreichte , wird die endgültige 	Entscheidung 	zwischen den beiden Bestplazierten in einer Stichwahl in zwei Wochen fallenkeywordtag . 
Entscheidung_s8166_f1	Die erste Runde bei den polnischen Präsidentschaftswahlen am Sonntag hat keine 	Entscheidung 	gebracht . 
Entscheidung_s8908_f1		Entscheidung 	zu Pille überrascht Gynäkologen 
Entscheidung_s8918_f1	Mit der 	Entscheidung 	habe man mögliche Gesundheitsrisiken ausschalten wollen . 
Entscheidung_s8921_f1	`` Völlig unverständlich '' nannte Professor Ludwig-Wilhelm Braendle vom Universitätskrankenhaus Eppendorf in Hamburg die 	Entscheidung 	der Behörde . 
Entscheidung_s8922_f1	Das Pharmaunternehmen Schering will gegen die 	Entscheidung 	Widerspruch einlegen . 
Entscheidung_s8923_f1	Das Unternehmen Organon sieht eine `` gute Chance '' , daß die Berlinerkeywordtag 	Entscheidung 	noch modifiziert werden könnte . 
Entscheidung_s8924_f1	Der SPD-Gesundheitspolitiker Horst Schmidbauer kritisierte in Bonn die 	Entscheidung 	der Behörde . 
Entscheidung_s8926_f1	Die Grünen nannten die 	Entscheidung 	des Bundesinstituts `` lau '' . 
Entscheidung_s8954_f1	Im konkreten Fall darf der Kurde allerdings trotz der 	Entscheidung 	der Bundesrichter nicht in die Türkei abgeschoben werden , weil ihm dort nach den Feststellungen der Vorinstanz politische Verfolgung droht . 
Entscheidung_s8956_f1	Der 9. Senat des Bundesverwaltungsgerichts äußerte sich in seinerkeywordtag 	Entscheidung 	nicht zur Verfassungsgemäßheit der Drittstaatenregelung . 
Entscheidung_s8969_f1	Diese 	Entscheidung 	gab Präsident Guntis Ulmanis am Dienstag vor dem neu zusammengetretenen Parlament ( Saeima ) bekannt . 
Entscheidung_s9041_f1	Er wisse nichts von einer 	Entscheidung 	Washingtonskeywordtag , Informationen zurückzuhalten . 
Entscheidung_s9136_f1	Dieskeywordtag müsse aber eine gemeinsamekeywordtag 	Entscheidung 	seinkeywordtag . 
Entscheidung_s9139_f1	Eine 	Entscheidung 	könne noch nicht getroffenkeywordtag werden , solange die Zeit dafür noch nicht reif sei . 
Entscheidung_s9635_f1	Mit der 	Entscheidung 	bekräftigte das BVG seine umstrittene Rechtsprechung vom vergangenen Jahr . 
Entscheidung_s9734_f1	Man müsse die 	Entscheidung 	über weitere Subventionen sorgfältig prüfen : 
Entscheidung_s9752_f1	Die 	Entscheidung 	wurde am letzten Ende des Parteitages getroffenkeywordtag , zwischen Tür und Angel . 
Entscheidung_s9837_f1	In einem Fall ergingkeywordtag die 	Entscheidung 	einstimmigkeywordtag , ansonsten mit fünf zu drei Richterstimmen . 
Entscheidung_s9840_f1	Der Senat verlangt in seinerkeywordtag 	Entscheidung 	von den Strafgerichten eine Abwägung zwischen dem Recht auf freie Meinungsäußerung und dem Schutz vor Ehrverletzungen . 
Entscheidung_s10096_f1	Über diese 	Entscheidung 	war spekuliert worden , seit der Geschäftsführer von Gesamtmetall , Dieter Kirchner , Ende September angekündigt hatte , er werde nach 27jähriger Amtszeit vorzeitig ausscheiden . 
Entscheidung_s10183_f1	Hört man Verteidigungsminister Volker Rühe oder den Sprecher der Liberalen , dann gibt es schon wieder eine spektakuläre 	Entscheidung 	aus Karlsruhe . 
Entscheidung_s10195_f1	Es scheint da eher ein Bonner Spektakel vorzuliegen als eine spektakuläre 	Entscheidung 	. 
Entscheidung_s10288_f1	Die 	Entscheidungen 	basierten noch immer `` einseitig auf Berichten des Auswärtigen Amtes '' über die Situation in den Herkunftsländern , obwohl das Amt selbst darauf hingewiesen habe , daß es keinen Anspruch auf Vollständigkeit erhebe und ergänzende Quellen von Menschenrechtsorganisationen empfehle . 
Entscheidung_s10295_f1		Entscheidung 	verschoben 
Entscheidung_s10301_f1	`` Wir brauchen eine einvernehmlichekeywordtag 	Entscheidung 	'' , sagte der Sprecher des US-Außenministeriums , `` an dem Punkt sind wir noch nicht . '' 
Entscheidung_s10637_f1	Thierse empfahl ebenfalls , erst im Dezember eine 	Entscheidung 	zu treffenkeywordtag . 
Entscheidung_s10640_f1	Eine 	Entscheidung 	des Sonderparteitages lag bis Redaktionsschluß dieser Ausgabe nicht vor . 
Entscheidung_s10767_f1	Bei der 	Entscheidung 	habe die Angst Alma Powells vor Attentaten eine Hauptrolle gespielt . 
Entscheidung_s10809_f1	Gegen die 	Entscheidung 	des Amtsgerichts will die Treuhand-Nachfolgerin , die Bundesanstalt für vereinigungsbedingte Sonderaufgaben ( BVS ) , Beschwerde einlegen . 
Entscheidung_s11079_f1	Die 	Entscheidung 	sei einstimmigkeywordtag gefallenkeywordtag , betonte General Victor Malu . 
Entscheidung_s11080_f1	Nach den vorliegenden Dokumenten sei die 	Entscheidung 	des Sondergerichtes gegen Saro-Wiwa `` zufriedenstellend '' gewesen . 
Entscheidung_s11092_f1	Lacher signalisierte , daß er gegen die 	Entscheidung 	Einspruch einlegen werde . 
Entscheidung_s11093_f1	Schneider hatte bereits vor der 	Entscheidung 	angekündigt , alle rechtlichen Möglichkeiten gegen eine Auslieferung ausschöpfen zu wollen . 
Entscheidung_s11422_f1	es fällt ihm lästig , immer wieder selbstkeywordtag 	Entscheidungen 	treffenkeywordtag zu müssen ; 
Entscheidung_s11895_f1	Allerdings nennt er einige Themen , zu denen sich beide Kandidaten vor einer 	Entscheidung 	öffentlich äußern müßten : 
Entscheidung_s12153_f1	Für Büschgen signalisieren 	Entscheidungen 	deutscher Banken für Investmentbanking an der Themse das Akzeptieren `` höherer Leistungsfähigkeit und größeren Bedeutungsgewichts Londons und können damit Resignation für den Finanzplatz Frankfurt bedeuten '' . 
Entscheidung_s12165_f1	Bei der 	Entscheidung 	spielte nicht nur die wirtschaftliche Tragfähigkeit des neuen Unternehmens eine Rolle , das einen `` optimalen Fertigungsablauf '' sicherstelle . 
Entscheidung_s12340_f1	Die Ausländerbehörde soll bei aufenthaltsrechtlichenkeywordtag 	Entscheidungen 	`` humanitäre Gesichtspunkte '' beachten und `` zugunsten der Ausländer entscheiden , sofern nicht zwingende öffentliche Gründe dem entgegenstehen '' . 
Entscheidung_s12391_f1	Die EKD hatte in dem Streit um das `` Kruzifix-Urteil '' des BVG vom Sommer immer wieder betont , daß trotz aller Kritik an der 	Entscheidung 	der Richter darauf geachtet werden müsse , daß die Autorität des Verfassungsgerichts als eine der demokratischen Säulen der Bundesrepublik nicht beschädigt werden dürfe . 
Entscheidung_s12394_f1	1. Die 	Entscheidung 	des BVGs zu den Äußerungen , Soldaten sind Mörder ' oder , Soldaten sind potentielle Mörder ' will der Meinungsfreiheit dienen . 
Entscheidung_s12440_f1	Acht Vertreter signalisierten ihren Unmut über die 	Entscheidung 	, darunter auch die Grünen , die mit Clintons Umweltpolitik nicht zufrieden sind . 
Entscheidung_s12711_f1	Nachkeywordtag einer 	Entscheidung 	des Bundessozialgerichts ( BSG ) müssenkeywordtag für die Beitragszeiten im Westen in bestimmten Fällen auch die entsprechenden Bewertungsgrundsätze gelten ( AZ : 13 / 4 RA 19 / 94 ) . 
Entscheidung_s12716_f1	Die Bundesversicherungsanstalt geht davon aus , daß aufgrundkeywordtag dieser 	Entscheidung 	( auf Antrag ) auch die Renten anderer Betroffener mit einem erheblichen Aufwand neu berechnet werden müssenkeywordtag . 
Entscheidung_s12746_f1	Verantwortung trifft aber auch Chirac , derkeywordtag , anders als er es im Wahlkampf verhieß , sich nicht damit begnügte , die großen Linien festzulegen und der Regierung die Führung der Politik zu überlassen , sondern alle wichtigen 	Entscheidungen 	im Elysée-Palast selbstkeywordtag trafkeywordtag , ohne daß eindeutige Orientierungen zu erkennen gewesen wären . 
Entscheidung_s12937_f1	Gegen diese 	Entscheidung 	legte der DFB Beschwerde beim Kammergericht ein . 
Entscheidung_s13032_f1		Entscheidung 	fälltkeywordtag vermutlich erst nach Landtagswahlen 
Entscheidung_s13054_f1	Vor den drei Landtagswahlen am 24. März , so hieß es , werde keine 	Entscheidung 	fallenkeywordtag . 
Entscheidung_s13100_f1	Vor den drei Landtagswahlen am 24. März , so hieß es , werde keine 	Entscheidung 	fallenkeywordtag . 
Entscheidung_s13114_f1	Schneiders Anwälte wollen gegen die 	Entscheidung 	durch alle Instanzen gehen . 
Entscheidung_s13155_f1	Begründet wurde die 	Entscheidung 	damit , beide Parteien hätten nicht genug Unterschriften zusammengebracht , die für eine Anmeldung zu den Wahlen nötig seien . 
Entscheidung_s13172_f1	Die Anwälte des überschuldeten Bauunternehmers Jürgen Schneider haben die 	Entscheidung 	der amerikanischen Justiz angefochten , ihn nach Deutschland auszuliefern . 
Entscheidung_s13181_f1	Die 	Entscheidung 	in der Sache obliegekeywordtag der Justiz in Deutschland . 
Entscheidung_s13188_f1	Der Frankfurter Staatsanwalt Dieter Haike sagte in Miami , er sei erfreut über die 	Entscheidung 	. 
Entscheidung_s13379_f1	Die Deutsche Bank und die Frankfurter Staatsanwaltschaft haben die 	Entscheidung 	zur Auslieferung des Immobilienspekulanten Jürgen Schneider begrüßt . 
Entscheidung_s13383_f1	Die Anwälte des Immobilienspekulanten kündigten Widerspruch gegen die 	Entscheidung 	an , was Schneiders Rückkehr nach Deutschland um Monate verzögern dürfte . 
Entscheidung_s13397_f1	`` Die Deutsche Bank begrüßt die 	Entscheidung 	. 
Entscheidung_s13401_f1	Jetzt könne die Behörde `` mit Gelassenheit weiteren 	Entscheidungen 	entgegensehen '' . 
Entscheidung_s13561_f1	Die Sprecherin der Arbeitsgruppe ``Sekten''-Politik der SPD im Bundestag , Renate Rennebach , begrüßte die 	Entscheidung 	von Innenminister Manfred Kanther ( CDU ) . 
Entscheidung_s13577_f1	Die 	Entscheidung 	der nigerianischen Militärregierung , die Todesurteile gegen neun Menschenrechtler zu bestätigen , ist international und bei Nigerias Opposition auf scharfe Kritik gestoßen . 
Entscheidung_s13624_f1	Er verzichte auf eine Kandidatur für jegliches politische Amt , da er nicht die Berufung für ein politisches Leben verspüre , erklärte Powell - er ist der erste Schwarze an der Spitze der US-Streitkräfte - zur Begründung seinerkeywordtag 	Entscheidung 	am Mittwoch auf einer Pressekonferenz in Alexandria bei Washington . 
Entscheidung_s13750_f1	Das Stuttgarter Amtsgericht sah es als erwiesen an , daß die 	Entscheidungen 	über umstrittene Dienstreisen ins Ausland nicht von den Abteilungsleitern , sondern vorwiegend vom damaligen Lotto-Chef Peter Wetter getroffenkeywordtag wurden . 
Entscheidung_s13751_f1	Die beiden Lotto-Abteilungsleiter müssen nach der 	Entscheidung 	des Gerichts `` wegen geringer Schuld '' Bußgelder von 25 000 und 20 000 Mark an gemeinnützige Einrichtungen bezahlen . 
Entscheidung_s13797_f1	Vor einer Reform des Beamtenrechts ist eine gründliche Diskussion mit Folgen für die Rollenverteilung zwischen Staat und Privaten sowie über die Verwaltungs- und Finanzreform unverzichtbar , die zu konkreten Ergebnissen führen muß über - die Definition hoheitlicher Aufgaben und damit über die 	Entscheidung 	, wo Beamte wirklich erforderlich sind ; - die Reform des Haushaltsrechts , also vor allem die Abschaffung des kameralistischen Rechnungswesens ( ohne Kostenkontrolle ) , Formen eigenverantwortlicher Budgetierung und die dringend notwendige Verknüpfung von ökonomischen , ökologischen und sozialen Bedingungen ; - den Abbau überkommener Hierarchien und den Ausbau der Dezentralisierung öffentlicher Aufgaben mit Beteiligung des betroffenen Personals und - die Dienstrechtsreform mit einem Ausbau leistungsorientierter Anreize von einer Reform des Beurteilungswesens bis zu objektivierbaren Leistungszulagen . 
Entscheidung_s13889_f1	Mitkeywordtag einer 	Entscheidung 	der Luxemburger Europa-Richter wird in ein bis zwei Jahren gerechnetkeywordtag . 
Entscheidung_s14264_f1	Aber Monate , vielleicht ein Jahr , werden vergehen , bis die 	Entscheidung 	fälltkeywordtag . 
Entscheidung_s14268_f1	`` Wir mußten erst lernen , daß es nötig sein kann , eine britischekeywordtag 	Entscheidung 	in der deutschen Öffentlichkeit zu verteidigen , um die Köpfe und Herzen der Menschen zu gewinnen '' , sagt Rothermund . 
Entscheidung_s14269_f1	Noch einmal vorkeywordtag die 	Entscheidung 	gestelltkeywordtag , würde Shellkeywordtag die Brent-Spar-Besetzer nicht wieder mit Wasserwerfern traktieren , sondern sie einfach `` dort oben sitzen lassen '' . 
Entscheidung_s14349_f1	Die jüngstekeywordtag 	Entscheidung 	der britischen Regierung , trotz der weltweiten Proteste gegen die französischen Atomversuche im Südpazifik das Atomtestprogramm des französischen Präsidenten Jacques Chirac zu billigen und zu unterstützen , hat die Anrainerländer des Südpazifiks fast ebenso stark erschüttert , wie die Atomexplosionen im brüchigen Basalt-Sockel der Koralleninsel Mururoa selbst . 
Entscheidung_s14358_f1	Die 	Entscheidung 	der britischen Regierung , sich in der Frage der Kernwaffenversuche auf die Seite Chiracs zu stellen , wird von den Regierungen der südpazifischen Region als Fehler angesehen . 
Entscheidung_s14446_f1	Die Gerichte haben sich in diesem Zusammenhang auf eine 	Entscheidung 	des Bundesgerichtshofs gestützt , die gerade aus Anlaß herabsetzender Äußerungen über Soldaten ergangen ist . 
Entscheidung_s14447_f1	Der Bundesgerichtshof geht inkeywordtag dieser 	Entscheidung 	davon aus , daß die Anforderungen , die das Reichsgericht an die Strafbarkeit von Sammelbeleidigungen gestellt hatte , nämlich , daß es sich um eine abgrenzbare und überschaubare Gruppe handeln müsse , den rechtsstaatlichen Erfordernissen der Eingrenzung von Straftatbeständen nicht genügten . 
Entscheidung_s14472_f1	Die Gerichte haben dies überwiegend unter Berufung auf die erwähnte 	Entscheidung 	des Bayerischen Obersten Landesgerichts ( NJW 1991 , S. 1493 ) angenommen , die eine ganz ähnliche Äußerung über Soldaten betraf . 
Entscheidung_s14473_f1	Diese 	Entscheidung 	gibt zwar die in der Verfassungsrechtsprechung entwickelten Grundsätze zur Schmähkritik zutreffend wieder , richtet die Rechtsanwendung aber nicht genügend daran aus . 
Entscheidung_s14495_f1	Die angegriffenen 	Entscheidungen 	müssen daher aufgehoben und die Sachen zurückverwiesen werden . 
Entscheidung_s14498_f1	Diese 	Entscheidung 	ist hinsichtlich der Verfassungsbeschwerden zu 1 ) , 3 ) und 4 ) mit fünf zu drei Stimmen , hinsichtlich der Verfassungsbeschwerde zu 2 ) im Ergebnis einstimmig ergangen . 
Entscheidung_s14610_f1	Eine gerichtlichekeywordtag 	Entscheidung 	sei nicht vorgesehen . 
Entscheidung_s14690_f1	Vorausgegangen war eine 	Entscheidung 	des Bundesgerichtshofes , mit der die Revision gegen das Urteil des Landgerichtes Karlsruhe vom April dieses Jahres abgelehnt wurde . 
Entscheidung_s15127_f1	Nach dieser 	Entscheidung 	, die Powell Mittwochabend ( MEZ ) in Alexandria bei Washington mitteilte , zeichnet sich für 1996 ein Rennen um das höchste Amt der USA zwischen Clinton und dem 72jährigen Senator Bob Dole ab , der im Feld der bislang über zehn republikanischen Bewerber mit Abstand vorne liegt . 
Entscheidung_s15219_f1	Das geht aus einer 	Entscheidung 	des Bundessozialgerichtes ( BSG ) in Kassel hervor . 
Entscheidung_s15227_f1	Eine solche 	Entscheidung 	nehme `` Verarmungsprozesse bewußt in Kauf '' und verschiebe die `` Last der Arbeitslosigkeit auf die Kommunen '' , da ein großer Teil der Arbeitslosen wegen der Kürzung auf Sozialhilfe angewiesen sein werde . 
Entscheidung_s15246_f1	Mit der jetzigenkeywordtag 	Entscheidung 	wird aber festgestellt , daß nicht nur der klassische Aufhebungsvertrag zu einer Sperre des Arbeitslosengeldes führen kann , sondern daß auch `` Vereinbarungen '' , die neben einer offiziellen Kündigung getroffen wurden und in denen sich der Mitarbeiter ( meist gegen Zahlung seitens des Arbeitgebers ) mit der Kündigung einverstanden erklärt , als Auflösung des Arbeitsverhältnisses gelten können . 
Entscheidung_s15354_f1	Ein `` Nein '' oder auch nur das Hinausschieben der 	Entscheidung 	wäre `` ein großer Rückschlag '' für den Demokratisierungsprozeß in der Türkei , sagte er . 
Entscheidung_s15911_f1	Die Bundesregierung klagt auf Druck von Bayern vor dem Europäischen Gerichtshof gegen die 	Entscheidung 	, bayerische Darlehen von 75 Millionen Mark als verbotene Subventionen einzustufen . 
Entscheidung_s15916_f1	Wie Pressesprecher Rainer Woihsyk am indirekt bestätigte , wird die 	Entscheidung 	am Montag offiziell im Anschluß an die Verwaltungsratssitzung der Staatstheater bekanntgegeben . 
Entscheidung_s16336_f1	Die Subventionen der Hansestadt an die Hamburger Stahlwerke ( HSW ) sind nach einer 	Entscheidung 	der Europäischen Kommission unzulässig und müssen zurückgezahlt werden . 
Entscheidung_s16341_f1	Ein Sprecher der Wirtschaftsbehörde nannte die 	Entscheidung 	`` völlig unverständlich '' . 
Entscheidung_s16408_f1	Obgleich Frankreich in Europa damit ziemlich allein steht , ist es bisher gelungen , die mörderischsten 	Entscheidungen 	abzuwenden , die im wirtschaftsliberalistischen Geiste den Weg zur Hollywood-Hegemonie geebnet hätten ; 
Entscheidung_s17654_f1	Da nämlich Wirtschaft eben nicht nur in `` der Wirtschaft '' stattfindet , sondern auch in etlichen anderen Bereichen - wie etwa dem Umweltschutz oder einem langfristigen Bildungsverhalten - , wokeywordtag aber aufgrund des individuell-rationalen Optimierungskalküls des einzelnen und der Unternehmen vielfach gesamtwirtschaftlich suboptimale 	Entscheidungen 	gefälltkeywordtag werden , ist der Staat und damit die Wirtschaftspolitik im Dienste einer gesellschaftlich effizienten Marktwirtschaft gezwungen , sich einzuschalten . 
Entscheidung_s17862_f1	Selbst bei Facharbeitern sind individualisierte 	Entscheidungs- 	und Handlungsdispositionen nämlich alltäglich geworden . 
Entscheidung_s18023_f1	Eine 	Entscheidung 	über die Vergabe des Kredit sei bislang noch nicht gefallenkeywordtag . 
Entscheidung_s18179_f1	Ob diese Technik zum Einsatz kommt , bleibtkeywordtag der 	Entscheidung 	nachfolgender Generationen vorbehaltenkeywordtag . 
Entscheidung_s18762_f1	Die Türkei hat die 	Entscheidung 	des Europäischen Parlaments scharf kritisiert , den Sacharow-Preis an die inhaftierte kurdische Politikerin Leyla Zana zu verleihen . 
Entscheidung_s18777_f1	Die EU dürfe die 	Entscheidung 	über die umstrittene Zollunion mit der Türkei nicht auf die lange Bank schiebenkeywordtag - diese Ansicht vertrat der Präsident des Europaparlaments , Klaus Hänsch . 
Entscheidung_s18778_f1	Obwohl viele Abgeordnete schlicht noch unentschieden seien , könne man die 	Entscheidung 	nicht auf unabsehbare Zeit vertagen , sagte Hänsch am Freitag in Brüssel . 
Entscheidung_s19345_f1	Mit der 	Entscheidung 	reagierte die Bundestagsmehrheit darauf , daß Teheraner Regierungspolitiker den Mord an Israels Ministerpräsident Yitzhak Rabin gerechtfertigt hatten . 
Entscheidung_s19586_f1	Eine 	Entscheidung 	gibt es aber noch nicht '' , erklärt ein VW-Sprecher . 
Entscheidung_s20035_f1	Die 	Entscheidungen 	überzeugten schon weniger . 
Entscheidung_s20600_f1	Löwe stütze erkennbar Absichten aus der CDU , per Gesetz die Karlsruherkeywordtag 	Entscheidung 	zu Makulatur zu machen . 
Entscheidung_s20888_f1	Außenminister Klaus Kinkel ( FDP ) , der wegen seiner Iran-Politik nicht nur von der Opposition , sondern auch von Mitgliedern der Koalitionsfraktionen scharf angegriffen wird , hat Rücktrittsforderungen zurückgewiesen und seinekeywordtag 	Entscheidung 	, die geplante Islam-Konferenz zu verschieben , verteidigt . 
Entscheidung_s20966_f1	Bürger müßten inzwischen teils mehrere Jahre auf eine erstinstanzliche 	Entscheidung 	in existentiell bedeutsamen Angelegenheiten warten . 
Entscheidung_s21079_f1	Die 	Entscheidung 	für den neuen Verkehrsweg trafenkeywordtag im Mai 1992 die Staaten Zentralasiens und Iran . 
Entscheidung_s21236_f1	Die Europäische Union ( EU ) sollte nach Auffassung von CSU-Chef und Bundesfinanzminister Theo Waigel bei 	Entscheidungen 	über die Außen- und Sicherheitspolitik vom Einstimmigkeitsprinzip abrücken . 
Entscheidung_s21238_f1	Auch bei 	Entscheidungen 	, die den Einsatz militärischer Mittel einschließen , dürfe eine Minderheit von Staaten die Mehrheit nicht am gemeinsamen Handeln hindern . 
Entscheidung_s21259_f1	Widerspruch wollen die Berliner gegen die 	Entscheidung 	des Bundesinstitutes für Arzneimittel und Medizinprodukte einlegen , die Verordnung von Pillen der dritten Generation wegen des Verdachts erhöhten Thromboserisikos zu beschränken . 
Entscheidung_s21606_f1	Diese 	Entscheidung 	sei von den Spitzen der Regierungskoalition mitgetragen worden . 
Entscheidung_s21748_f1	Obwohl die Krise BMW kalt erwischte , zweifelt Baumgartner die 	Entscheidung 	, 170 Millionen Dollar zu investieren , nicht an . 
Entscheidung_s22637_f1	Zwar begründete Hamas die 	Entscheidung 	mit demographischen Argumenten - selbst wenn sich Hamas gegen die Gründung einer Partei entschiede , wisse man nach den Wahlen , wie viele sich einem Boykott angeschlossen hätten . 
Entscheidung_s22877_f1	`` Ein Großteil '' der 	Entscheidungen 	, die Einwanderer und Minderheiten betreffen , werde bislang auf Bundes- und Landesebene getroffenkeywordtag , ohne diese anzuhören . 
Entscheidung_s22945_f1	`` 	Entscheidungen 	sind aber noch nicht gefallenkeywordtag '' , betont Sprecher Christian Hoppe . 
Entscheidung_s23027_f1	am Sonntagabend verschobkeywordtag eskeywordtag seinekeywordtag 	Entscheidung 	, zunächst einmal aufs Ende dieses Jahres . 
Entscheidung_s23230_f1	Anlaß für die Kasselerkeywordtag 	Entscheidung 	war der Fall eines Tamilen aus Sri Lanka . 
Entscheidung_s23255_f1	Als er gefragt wird , ob er zurücktreten würde , wenn ein Gericht entscheide , daß er mit seiner falschen Vermögenserklärung gegen geltendes Recht verstoßen habe , beschränkt er sich auf die Versicherung , daß die 	Entscheidung 	gewiß zu seinen Gunsten ausfallenkeywordtag werde . 
Entscheidung_s23344_f1	Das Bundesverfassungsgericht habe seinekeywordtag 	Entscheidung 	, die Verwendung des Zitats von Kurt Tucholsky nicht generell als strafbar einzustufen , damit begründet , daß die geltende Rechtslage kein anderes Urteil zulasse . 
Entscheidung_s23488_f1	Bereits ein Jahr zuvor , Anfang 1998 , erwartet das EWI die 	Entscheidung 	darüber , welche Länder die Kriterien des Maastrichter Vertrages erfüllen und von Beginn an Teilnehmer der EWU sein werden . 
Entscheidung_s23571_f1	Die Organisation begründete ihrekeywordtag 	Entscheidung 	in der Hauptstadt Colombo damit , daß sich eine entscheidene Schlacht zwischen den Tamilenrebellen und Regierungstruppen anbahne . 
Entscheidung_s23611_f1	Die 	Entscheidung 	sei schwierig gewesen und erst nach siebenmonatigen Konsultationen gefallenkeywordtag . 
Entscheidung_s23941_f1	Die CDU-Mehrheit begründete ihrekeywordtag 	Entscheidung 	mit dem Zwang zum Sparen . 
Entscheidung_s24348_f1	Die chinesische Regierung nahm die 	Entscheidung 	des Dalai Lama im Mai dieses Jahres jedoch nicht zur Kenntnis . 
Entscheidung_s24401_f1	Ausschlaggebend für die 	Entscheidung 	wird letztlich der Preis für den Anschluß sein . 
Entscheidung_s24542_f1	Die zwei Jahre bis zur 	Entscheidung 	über den Teilnehmerkreis sind , wie Lamfalussy zu Recht feststellt , noch Zeit genug für Überraschungen : für schlechte wie für gute . 
Entscheidung_s24752_f1	Von seinerkeywordtag 	Entscheidung 	werde ihn auch der Disziplinararrest nicht abbringen , sagte Arndt . 
Entscheidung_s24885_f1	Der Präsident der Bundesvereinigung der Deutschen Arbeitgeberverbände , Klaus Murmann , ließ verlauten , er unterstütze die 	Entscheidung 	für Stumpfe . 
Entscheidung_s24896_f1	Bis zur Anfang 1998 anstehendenkeywordtag 	Entscheidung 	, welche Mitglieder zum Währungsclub zugelassen werden , habe man Zeit genug , gute oder schlechte Überraschungen zu erleben . 
Entscheidung_s25223_f1	Nach massiver Kritik von Abgeordneten hatte die Unionsfraktion ihrekeywordtag 	Entscheidung 	vertagt . 
Entscheidung_s25240_f1	In einem Gespräch mit der Frankfurter Rundschau sagte Musawjan , Kinkel habe mit seinerkeywordtag 	Entscheidung 	der Tatsache Rechnung getragen , daß bei einem Dialog zwischen dem Westen und der islamischen Welt Teheran nicht fehlen dürfe . 
Entscheidung_s25293_f1	Das Bonner Justizministerium stützte seinekeywordtag 	Entscheidung 	nun auf den zwischen beiden Länder vereinbarten Auslieferungsvertrag . 
Entscheidung_s25469_f1	Die FDP-Bundestagsfraktion hat Bundesinnenminister Manfred Kanther aufgefordert , auf Abschiebungen von Ausländern zunächst zu verzichten und 	Entscheidungen 	des Parlaments zum Aufenthaltsrecht für Bürgerkriegsflüchtlinge und für Altfälle abzuwarten . 
Entscheidung_s25524_f1	Hinzu kam die Bonnerkeywordtag 	Entscheidung 	, im Streit über die Rückführung der 40 000 Vietnamesen die Entwicklungshilfe vorübergehend zu stoppen . 
Entscheidung_s25860_f1	Das Potsdamer Polizeipräsidium reichte am Mittwoch Beschwerde gegen die 	Entscheidung 	des Verwaltungsgerichts Potsdam ein , das dem Widerspruch der Berliner `` Kulturgemeinschaft Preußen e. V. '' gegen das Verbot eines Aufmarsches auf dem Soldatenfriedhof Halbe stattgegeben hatte . 
Entscheidung_s25986_f1	Israels amtierender Ministerpräsident Shimon Peres hat für schmerzvolle 	Entscheidungen 	im Friedensprozeß mit Syrien geworben . 
Entscheidung_s26081_f1	Andererseits werden Menschen , die schnelles Handeln erwarten , mit einer schwerfälligen , machtverwöhnten politischen Klasse in den Parteien und den Parlamentsfachausschüssen konfrontiert , die in ihrer Verflechtung mit den großen traditionellen Verbänden über eine aus Informationsvorsprung und speziellen Fachkenntnissen bestehende strategische Kompetenz verfügt und in der Regel die Erwartungen mit nicht nachvollziehbaren 	Entscheidungen 	enttäuscht , die daraus resultierende Bürgerkritik nicht zur Kenntnis nimmt und alles tut , sie zum Verstummen zu bringen . 
Entscheidung_s26105_f1	Vielmehr eröffnet es gesellschaftlichen Gruppen die Chance , Fehlentscheidungen des Parlaments und der Regierung zu korrigieren und den Legitimationsdruck für 	Entscheidungen 	von existentieller Bedeutung wirksam zu erhöhen . 
Entscheidung_s26109_f1	Zweitens stärkt die Möglichkeit der Beteiligung an politischenkeywordtag 	Entscheidungen 	die Motivation und Eigeninitiative der Menschen , bei der Lösung von gesellschaftlichen Problemen mitzuwirken , die sie unmittelbar betreffen . 
Entscheidung_s26807_f1	`` Ichkeywordtag habe die 	Entscheidung 	aus einem Gefühl tiefer Menschlichkeit getroffenkeywordtag '' , erläuterte er seinen Schritt : 
Entscheidung_s26875_f1	Richard Goldstone lehnt es ab , 	Entscheidungen 	des Gerichts als Verhandlungsmasse im Friedensprozeß anzusehen 
Entscheidung_s26903_f1	In dem seit nunmehr zwei Jahrzehnten währenden Rechtsstreit um das Atomkraftwerk Mülheim-Kärlich stehtkeywordtag am kommenden Dienstag eine weitere 	Entscheidung 	bevorkeywordtag : 
Entscheidung_s26907_f1	Drei Jahre später lief ein neuer Prozeß über die 1300-Megawatt-Atomanlage an , nachdem das Bundesverwaltungsgericht Berlin im Revisionsverfahren den Prozeß zur erneuten 	Entscheidung 	nach Koblenz zurückverwiesen hatte . 
Entscheidung_s26923_f1	Für RWE steht dagegen fest : Nach der erwarteten positiven 	Entscheidung 	werde auch damit gerechnet , daß das Gericht über den Sofortvollzug befindet . 
Entscheidung_s27171_f1	Nach 93 Verhandlungstagen steht der Prozeß gegen die Verantwortlichen der Bluthandels-Firma UB Plasma vor dem Koblenzer Landgericht vor seinerkeywordtag 	Entscheidung 	. 
Entscheidung_s27397_f1	Parlamentspräsident Klaus Hänsch sagte am Mittwoch in Straßburg , er habe den Eindruck , daß `` die Diskussion weit genug gediehen '' sei , um am 13. Dezember eine 	Entscheidung 	zu fällen . 
Entscheidung_s27423_f1	Bis zu der endgültigen 	Entscheidung 	der Landespolizeidirektion , darf er vorläufig keinen Dienst versehen . 
Entscheidung_s28054_f1	Beide begründeten ihr Vorgehen mit dem Hinweis , daß die SPD endlich Klarheit über ihrekeywordtag personellenkeywordtag 	Entscheidungen 	brauche und eine fortdauernde Unsicherheit der Partei schaden würde . 
Entscheidung_s28062_f1	Der rheinland-pfälzische Ministerpräsident Kurt Beck sagte vor der Abstimmung im ZDF : `` Es bedarf der 	Entscheidung 	. '' 
Entscheidung_s28234_f1	Der Chefankläger des UN-Tribunals für Kriegsverbrechen in Ex-Jugoslawien , Richter Richard Goldstone , kritisierte die 	Entscheidung 	der kroatischen Regierung , General Tihomir Blaskic zu befördern , der in Den Haag wegen mutmaßlicher Verbrechen gegen die Menschlichkeit angeklagt ist . 
Entscheidung_s28236_f1	Der Sprecher des Außenministeriums , Nicholas Burns , sagte in Washington , daß diese 	Entscheidung 	gegen die Verpflichtung Kroatiens verstoße , bei den Ermittlungen gegen mutmaßliche Kriegsverbrecher zu helfen . 
Entscheidung_s28258_f1	Er forderte eine klare politische 	Entscheidung 	der mexikanischen Regierung , die Straflosigkeit zu beenden . 
Entscheidung_s28274_f1	`` Der Präsident fühlt sehr stark , daß er in den Vereinigten Staaten bleiben muß , um zu handeln und , falls nötig , sein Veto gegen 	Entscheidungen 	einzulegen , die nicht im Interesse des amerikanischen Volkes sind '' , sagte Regierungssprecher Michael McCurry . 
Entscheidung_s28474_f1	Diese 	Entscheidung 	gab am Donnerstag das Strafgericht in Lyon bekannt . 
Entscheidung_s28614_f1	Schließlich geht es um eine grundsätzliche 	Entscheidung 	, wie - möglicherweise - Tarifverträge ausgehebelt werden können . 
Entscheidung_s28889_f1	Solche Äußerungen mögen dazu beigetragen haben , daß Haiderkeywordtag laut höchstrichterlicherkeywordtag 	Entscheidung 	als `` politischer Ziehvater des rechtsxextremen Terrorismus '' bezeichnet werden darf . 
Entscheidung_s28979_f1	In der Tat dürfte der für die nächsten Tage erwartetenkeywordtag 	Entscheidung 	von Minister Schäfer über die drei umstrittenen Rotoren eine über den Schauinsland hinausgehende Bedeutung zukommen . 
Entscheidung_s29068_f1	Er konzediert zwar , daß sich Jacques Chirac bei der 	Entscheidung 	für die Fortdauer der Grenzkontrollen wegen des Ausnahme-Artikels im Schengen-Vertrag formal korrekt verhalte . 
Entscheidung_s29461_f1	Maos Einheitsgedanke von Staat , Partei und Volk findet sich insofern in einzelnen Artikeln ( Kap. I , Art. 17 , 18 ) , als die Partei- und Staatsfunktionäre in ihrenkeywordtag 	Entscheidungen 	an den Willen der Massen gebunden werden . 
Entscheidung_s29478_f1	Als hauptsächlich Studenten - sie glaubten zunächst noch an das alte Ideal der Einheit - auf dem Tian'anmen-Platz von der Parteiführung ( ! ) Rechenschaft über die durch die Reformen hergestellten Mißstände , beispielsweise die zunehmende Korruption unter den Parteikadern oder Gewaltverbrechen im öffentlichen Bereich , forderten , und die Partei an ihre Pflichten ( ! ) gegenüber dem Volk erinnerten , stand die Parteiführung vor der Frage , wie sie mit ihren letzten Zweifeln ( die Studenten konnten immerhin einige Wochen auf dem Tian'anmen-Platz demonstrieren , bis sich die Parteiführung zukeywordtag einer 	Entscheidung 	durchrangkeywordtag ) an den durch die Reformen erzeugten Gegensätzen in der Bevölkerung und deren angestrebter effektiver Benutzung für den chinesischen Reformstaat umgehen wollte . 
Entscheidung_s29613_f1	Aufgrund der Kasselerkeywordtag 	Entscheidung 	hat das Landessozialgericht Nordrhein-Westfalen nunmehr zu prüfen , ob die Zahlung tatsächlich ausschließlich an der umstrittenen Grenze im AFG scheiterte . 
Entscheidung_s29836_f1	Letztereskeywordtag kämekeywordtag , so verlautet aus der Oper , schwerlich vor Herbst 1996 zukeywordtag einer 	Entscheidung 	. 
Entscheidung_s30201_f1	Das Bundeskartellamt hat inkeywordtag einer noch nicht rechtskräftigen 	Entscheidung 	gegen vier saarländische Unternehmen der Lüftungs- und Klimatechnik sowie gegen deren Geschäftsführer und weitere Angestellte Bußgelder über insgesamt 570 000 Mark verhängt . 
Entscheidung_s30291_f1	Istkeywordtag daskeywordtag schon die 	Entscheidung 	? 
Entscheidung_s30426_f1	Eine 	Entscheidung 	ist noch nicht gefallenkeywordtag . '' 
Entscheidung_s30487_f1	Folgt man Firmenchef Gerd Krick , fällt seinekeywordtag 	Entscheidung 	für Friedberg völlig aus dem volkswirtschaftlichen Rahmen : 
Entscheidung_s30743_f3	`` Die Partei braucht Klarheit in politischenkeywordtag und in personellenkeywordtag 	Entscheidungen 	. '' 
Entscheidung_s31139_f1	Deutschlands Stimmenthaltung ging auf die 	Entscheidung 	von Kanzler Helmut Kohl und Außenminister Klaus Kinkel zurück , die Solidarität mit Frankreich nicht in Frage zu stellen . 
Entscheidung_s31459_f1	Beobachtern zufolge ist diese 	Entscheidung 	unter EU-Partnern beispiellos . 
Entscheidung_s31462_f1	Deutschlands Stimmenthaltung ging auf die 	Entscheidung 	von Bundeskanzler Helmut Kohl und Außenminister Klaus Kinkel zurück , die Solidarität mit Frankreich nicht in Frage zu stellen . 
Entscheidung_s32161_f1	Mit welcher Art `` politischerkeywordtag '' 	Entscheidung 	ließen sich solche Fragen beantworten und klären ? 
Entscheidung_s32404_f1	Auch Fritz Pleitgen mochte in seiner Runde , zu der er sich immerhin fünf journalistische Expertinnen eingeladen hatte , partout nicht auf die Querelen um den Tagungsort verzichten , obwohl die Kolleginnen ihm mit engelshafter Geduld und vereinten Kräften immer wieder erklärten , daß die 	Entscheidung 	für diesen Ort 1992keywordtag fast ausschließlich von Männern gefälltkeywordtag worden war . 
Entscheidung_s32694_f1	Ihr Ziel ist die demokratische Beteiligung der gastgebenden Bevölkerung in der Dritten Welt an 	Entscheidungen 	in Verbindung mit Tourismusentwicklung . 
Entscheidung_s32700_f1	Zwar steht eine 	Entscheidung 	des Gemeinderates noch aus . 
Entscheidung_s33576_f1	Nachdrücklich verteidigte Rühe die 	Entscheidung 	der Bundesregierung , sich mit 4000 Soldaten einschließlich Tornado-Kampfflugzeugen an der geplanten Friedenstruppe im ehemaligen Jugoslawien zu beteiligen . 
Entscheidung_s33578_f1	Bei den Gesprächen in Dayton ( USA ) gehe es bis Sonntag um die 	Entscheidung 	`` Krieg oder Frieden '' . 
Entscheidung_s34126_f1	Wer ein nicht allzu schweres Verbrechen begangen hat oder - heftig umstritten - als `` sozial gefährlich '' eingeschätzt wird , wird nach richterlicherkeywordtag 	Entscheidung 	innerhalb von fünf Tagen des Landes verwiesen . 
Entscheidung_s34171_f1	Diese Äußerungen hätten `` unwiderlegbar den Eindruck entstehen '' lassen , so urteilten Bräutigams Kollegen , `` dieser Richter nehme eine innere Haltung ein , die seine Unvoreingenommenheit und Unparteilichkeit einschränken und seinekeywordtag 	Entscheidung 	zum Nachteil des Angeklagten beeinflussen kann '' . 
Entscheidung_s34184_f1	Claudia Roth , Fraktionsvorsitzende der Grünen , nannte die 	Entscheidung 	`` Kotau vor der Türkei '' . 
Entscheidung_s34500_f1	In Frankreich sprach der Chef der sozialistischen Opposition , Lionel Jospin , von einer `` schwer verständlichen und bedauerlichen 	Entscheidung 	'' Chiracskeywordtag . 
Entscheidung_s34794_f1	1. Ein global voll deregulierter und liberalisierter Güter- und Kapitalfluß ist kein `` Schicksal '' , sondern warkeywordtag - zumindest für die großen Industriestaaten - eine gezielte politische 	Entscheidung 	. 
Entscheidung_s34838_f1	Von dieser Basis ausgehend müssen 	Entscheidungen 	im Sinne der Subsidiarität bürgernah und möglichst dezentral getroffenkeywordtag werden . 
Entscheidung_s35043_f1	Keine transnationale Unternehmung , keine internationale Finanzinstitution und kein sonstiger Akteur der Weltwirtschaft könnte eine Wirtschaftsmacht wie die Bundesrepublik Deutschland , geschweige denn , wie die Europäische Union daran hindern - die ungebrochene Respektierung demokratischer Strukturen , demokratischer Prozesse und demokratischerkeywordtag 	Entscheidungen 	vorausgesetzt - notwendige und wünschenswerte Regulierungen des internationalen Handels- und Zahlungsverkehrs und der nationalen marktwirtschaftlichen Entwicklung im Interesse der genannten politischen , ökonomischen , sozialen und ökologischen Ziele von Vollbeschäftigung , sozialer Sicherheit , Umweltschutz und politischer Stabilität durchzusetzen . 
Entscheidung_s35764_f1	Die USA `` hatten keine Vorliebe für jemand , der zwölf Jahre Premier war und selbst 	Entscheidungen 	vorzuschlagen pflegt . 
Entscheidung_s35765_f1	Sie wollten lieber jemanden , der 	Entscheidungen 	ausführt . '' 
Entscheidung_s35905_f1		Entscheidung 	wegen Streits mit Partnern verschoben 
Entscheidung_s35907_f1	Die für Ende dieses Jahres vorgesehenekeywordtag 	Entscheidung 	über die Beschaffung des `` Eurofighters '' muß wegen Streitigkeiten mit den deutschen Partnerländern erneut verschoben werden . 
Entscheidung_s35909_f1	Die 	Entscheidung 	über den Kauf des Flugzeuges wird deshalb wohl erst im Frühjahr nächsten Jahres fallenkeywordtag . 
Entscheidung_s35915_f1	Für eine derartige 	Entscheidung 	fehlten die Grundlagen . 
Entscheidung_s35934_f1	Struck sagte der FR , es gehe jetzt darum , `` ein Frühwarnsystem '' einzurichten , um im Vorfeld politischerkeywordtag 	Entscheidungen 	rechtzeitig die Anliegen der Bundestagsfraktion , der Parteiführung und der Länder abzugleichen . 
Entscheidung_s35968_f1	Im Kampf zwischen ihm und dem von der Republikanischen Partei beherrschten Kongreß um den richtigen Weg zur Sparsamkeit gehe es nicht `` um politische Spielchen '' , sondern um die 	Entscheidung 	zwischen `` zwei grundlegend unterschiedlichen Auffassungen von unserem Land und seiner Zukunft '' . 
Entscheidung_s36263_f1	Der Arbeitgeber darf diese 	Entscheidung 	nicht beeinflussen . 
Entscheidung_s36315_f1	Auf jeden Fall würden die Amerikaner zunächst von Lieferaufträgen im Rahmen von IDA 11 sowie von allen 	Entscheidungen 	bei der Bank-Tochter ausgeschlossen . 
Entscheidung_s37082_f1	Die 	Entscheidung 	für die Assekuranz an der leine sei im lenbkungsauschuß `` in völliger Übereinstimmung '' getroffenkeywordtag worden , betont die Postbank . 
Entscheidung_s37097_f1	Die 	Entscheidung 	für die Assekuranz von der Leine sei im Bonner Lenkungsausschuß , dem neben der Aufsicht und dem Ministerium auch die Post angehört , `` in völliger Übereinstimmung '' getroffenkeywordtag worden , betonen die Banker entgegen anderslautenden Meldungen . 
Entscheidung_s37120_f1	Das Aktionsbündnis zur Rettung des Brauhauses in der Sachsenmetropole wertet die 	Entscheidung 	als Teilerfolg . 
Entscheidung_s38158_f1	Bisher ist noch keine 	Entscheidung 	darüber getroffenkeywordtag worden , ob alle Niederlassungen geschlossen oder in einigen Häusern noch Restbestände verkauft werden , sagte ein Justizsprecher . 
Entscheidung_s38510_f1	`` Eine ganz klare 	Entscheidung 	für eine europäische Hartwährung '' erkannte Bundesfinanzminister Theo Waigel ( CSU ) , der Euro werde nicht nur bei seiner Einführung hart sein , sondern auch so hart bleiben , `` wie die D-Mark es heute ist '' , sekundierte sein Kollege fürs Auswärtige , Klaus Kinkel ( FDP ) . 
Entscheidung_s38699_f1	`` Großzügige Liquiditätshilfen '' wie im Fall Mexikos , gibt Lipp allenfalls zu Bedenken , bewahrten `` Schuldner und Gläubiger vor Verlusten und damit vor den Konsequenzen ihrerkeywordtag eigenen 	Entscheidungen 	'' . 
Entscheidung_s39036_f1	Ihm bleibt der Rechtsweg offen , wenn er mit der 	Entscheidung 	nicht einverstanden ist . 
Entscheidung_s39267_f1	Die Richter gaben mit ihrerkeywordtag 	Entscheidung 	der Klage der Gewerkschaftsvertreter gegen Renault statt . 
Entscheidung_s39498_f1	Die Anteilseigner von Hoechst haben auf der Hauptversammlung am 6. Mai weitreichende 	Entscheidungen 	zu treffenkeywordtag . 
Entscheidung_s39703_f1	Geschäftsführer Christian Ehlers fordert schnelle 	Entscheidungen 	zur Steuerreform , damit die Verunsicherung beendet werde : 
Entscheidung_s39826_f1	Und natürlich spielt die um einiges positivere Einstellung der Blair-Partei zu Europa eine Rolle - zumal vor einer schwerwiegenden 	Entscheidung 	wie der über die Währungsunion , die trotzdem höchstwahrscheinlich ohne die Briten beginnt . 
Entscheidung_s40112_f1	Eine endgültige 	Entscheidung 	über den Beitritt zur Währungsunion könne frühestens Anfang 1998 getroffenkeywordtag werden . 
Entscheidung_s40266_f1	Dadurch würden mögliche Ansprüche gesichert und die endgültige Festsetzung der Jahressteuerschuld bis zu einer höchstrichterlichenkeywordtag 	Entscheidung 	zurückgestellt . 
Entscheidung_s40396_f1	Bis zur 	Entscheidung 	über den neuen Chef soll Mitbegründer Jobs das Management bei Produktstrategie und Marketing beraten . 
Entscheidung_s40424_f1	Vor der endgültigen 	Entscheidung 	über Art und Zeitpunkt der Privatisierung muß festgelegt werden , ob das Institut künftig mit je einem Unternehmen aus der Versicherungs- und der Bausparbranche zusammenarbeiten soll . 
Entscheidung_s41106_f1	Eine Abtrennung werde `` eingehend untersucht und dem Vorstand im September zurkeywordtag 	Entscheidung 	vorgelegtkeywordtag '' , heißt es . 
Entscheidung_s41279_f1	Neue Kraft verlieh dem Dollar die 	Entscheidung 	der Bundesbank , vorerst auf eine zinspolitische Stützung der Mark zu verzichten . 
Entscheidung_s41514_f1	Die 	Entscheidung 	stehe noch unter `` Gremienvorbehalt '' , sagte ein Ministeriumssprecher . 
Entscheidung_s41640_f1	Frankreichs Premierminister Lionel Jospin hat `` bedeutende 	Entscheidungen 	'' für die Rüstungsindustrie des Landes angekündigt . 
Entscheidung_s42219_f1	Nach HBV-Ansicht tragen die 	Entscheidungen 	über die künftige Struktur des Bankriesen `` deutlich '' den Stempel von Schmidt , der das vereinigte Institut mit rund 740 Milliarden Mark Bilanzsumme und 40 000 Beschäftigten führen soll . 
Entscheidung_s42396_f1	Mehrere regionale Gasverteiler müssenkeywordtag nachkeywordtag einer 	Entscheidung 	des Bundeskartellamts ihre Preise in Ostdeutschland zurücknehmen . 
Entscheidung_s42401_f1	Sie stützen sich dabei auf 	Entscheidungen 	des Bundesgerichtshofes und des Berliner Kammergerichts , in denen regionalen Gasversorgern höhere Preise als vergleichbaren Anbietern im Prinzip untersagt wurden . 
Entscheidung_s42662_f1	Mit der Anrufung der nächsten Instanz drängt der Vorstand auf eine Klärung , an welchem Punkt Mitbestimmung und Mitwirkung der Arbeitnehmervertreter bei unternehmerischenkeywordtag 	Entscheidungen 	zu beginnen und wie sie im Detail auszusehen haben . 
Entscheidung_s43099_f1	Noch sei aber keine 	Entscheidung 	darüber gefallen , ob es eine Routineüberprüfung wegen eventueller Verstöße gegen das Handelsverbot für Insider ( Manager , Aufsichtsräte ) geben werde , teilt Behördensprecher Jürgen Oberfrank mit . 
Entscheidung_s43189_f1	Der Manager habe gegen Insiderregeln verstoßen , begründet die BvS ihrekeywordtag 	Entscheidung 	. 
Entscheidung_s43248_f1	Näher liegt freilich die Vermutung , daß die Top-Etage von Krupp in der Vergangenheit nicht die richtigen 	Entscheidungen 	gefälltkeywordtag hat , um die negativen Folgen des Strukturwandels in der Stahlindustrie zu minimieren und die Chancen auf anderen Geschäftsfeldern zu nutzen . 
Entscheidung_s44291_f1	Denn wenn sich die bei der Verabschiedung des Gesetzes unterstellten Notwendigkeiten für Investitionen verändert haben , könnten die Parlamentarier neue 	Entscheidungen 	über bestimmte Projekte anmahnen . 
Entscheidung_s44341_f1	Siekeywordtag kann aber nur mit Zustimmung Wellensieks 	Entscheidungen 	treffenkeywordtag . 
Entscheidung_s45199_f1	Die G-7-Gruppe , so der türkische Premier , `` fälltkeywordtag 	Entscheidungen 	und zwingt sie dem Rest der Welt auf '' . 
Entscheidung_s45328_f1	Während für Clement diese 	Entscheidung 	ein `` Grund zur hellen Freude '' ist , von der er sich einen Schub für die Gentechnologie im ganzen Land erhofft , meldete der bündnisgrüne Koalitionspartner Einwände gegen die Zukunftsträume des sozialdemokratischen Wirtschaftsministers an . 
Entscheidung_s46933_f1	Heute : 	Entscheidung 	über Brcko 
Entscheidung_s46935_f1	Die Schiedskommission zur Grenzziehung in der nordbosnischen Stadt Brcko wird am heutigen Freitag in Rom ihrekeywordtag 	Entscheidung 	bekanntgeben . 
Entscheidung_s46946_f1	US-Außenministerin Madeleine Albright hat unterdessen dem bosnischen Präsidenten Alija Izetbegovic telefonisch mitgeteilt , es habe nach der von Diplomaten verbreiteten 	Entscheidung 	noch Änderungen zugunsten der Moslems gegeben . 
Entscheidung_s46962_f1	Mit der Vereinbarung kam der Verlag einer 	Entscheidung 	des Arbeitsgerichts Köln nach , vor dem der 52jährige Journalist gegen die Kündigung geklagt hatte . 
Entscheidung_s47414_f1	Nach einem Gespräch mit seinem südkoreanischen Kollegen Yoo Chong Ha sagte Chinas Außenminister Qian Qichen am Freitag in Singapur , seine Regierung benötige noch Zeit , um eine 	Entscheidung 	zu treffen . 
Entscheidung_s48689_f1	Ihrekeywordtag 	Entscheidung 	für Jena hatte gute Gründe . 
Entscheidung_s48796_f1	Diese 	Entscheidung 	werden die Außenminister der Europäischen Union spätestens im nächsten Jahr unter Beweis stellen müssen . 
Entscheidung_s49209_f1	Vor unbedachten 	Entscheidungen 	warnte der SPD-Politiker Jochen Poß bezüglich mit der von beiden Seiten im Grundsatz akzeptierten Spaltung des Spitzensteuersatzes für gewerbliche und private Einkommen . 
Entscheidung_s49252_f1	Mit dieser 	Entscheidung 	wies das Düsseldorfer Verwaltungsgericht am Freitag die Klage des Berliner Verlages gegen Kniola zurück . 
Entscheidung_s49328_f1	Seine Umweltministerin Heidrun Heidecke ( Bündnis 90 / Grüne ) hatte Niedersachsens Ministerpräsident Schröder vorgehalten , er erkaufe sich mit dem `` Faustpfand '' Morsleben , daß die 	Entscheidung 	für Schacht Konrad hinausgeschoben werde . 
Entscheidung_s49368_f1	Diese 	Entscheidung 	eines internationalen Schiedsgerichts gab dessen Vorsitzender , der US-amerikanische Diplomat Roberts Owen , am Freitag in Rom bekannt . 
Entscheidung_s49516_f1	Die 	Entscheidung 	über Brcko und Umgebung war bei den Friedensverhandlungen in Dayton im Herbst 1995 ausgeklammert worden . 
Entscheidung_s49521_f1	Die Schiedskommission unter Vorsitz des US-Diplomaten Roberts Owen hat ausdrücklich unter Hinweis auf die bestehenden Spannungen und die dürftigen Fortschritte des Friedensprozesses eine endgültige 	Entscheidung 	auf das Jahr 1998 verschobenkeywordtag . 
Entscheidung_s49567_f1	Daß die Schiedskommission ihrekeywordtag 	Entscheidung 	über Brcko jetzt zum zweiten Mal , verschoben hat , ist wahrlich kein glanzvoller Akt . 
Entscheidung_s49570_f1	Jede andere 	Entscheidung 	hätte heftigste Empörung ausgelöst . 
Entscheidung_s49612_f1	Die rechtsextremen `` Republikaner '' hatten mit ausufernden Redebeiträgen die 	Entscheidung 	über die Aussöhnungserklärung , die sie heftig ablehnen , tagelang verzögert . 
Entscheidung_s49633_f1	Die rechtsextremen `` Republikaner '' hatten mit ausufernden Redebeiträgen die 	Entscheidung 	über die Aussöhnungserklärung , die sie strikt ablehnen , tagelang hinausgezögert . 
Entscheidung_s49660_f1	Er wisse , daß die Erklärung für viele in der CSU , die bayerische Staatsregierung und die Sudetendeutschen eine `` schwerwiegende 	Entscheidung 	'' seikeywordtag . 
Entscheidung_s49704_f1	Die Palästinenser lehnten Israelskeywordtag 	Entscheidung 	ab , sich aus neun Prozent des Westjordanlandes zurückzuziehen . 
Entscheidung_s49710_f1	Die Palästinenser lehnten die 	Entscheidung 	Israelskeywordtag kategorisch ab und wollen weit mehr als nur neun Prozent der Fläche unter ihre Kontrolle bringen . 
Entscheidung_s49788_f1	Die 	Entscheidung 	müsse jetztkeywordtag getroffenkeywordtag werden . 
Entscheidung_s50403_f1	Sein ehemaliger Vorgesetzter , der Oberstaatsanwalt Hans Ellinger , ist sauer über die `` ungeheure Geldverschwendung '' - immerhin kostet eine höchstrichterlichekeywordtag 	Entscheidung 	den europäischen Steuerzahler im Schnitt rund eine halbe Million Mark . 
