erklaeren_s14_f1	So 	erklärt 	etwa Edward Brandon von dem Unternehmen National City in Ohio : 
erklaeren_s202_f1	Da die Gruppe in einem Flugblatt wörtlich 	erklärte 	, es sei ihr `` wichtiger denn je , gezielt gegen das System und seine Büttel vorzugehen '' , und auch den Molotow-Cocktail-Angriff auf das Holzhaus des früheren Führers der ultrarechten FAP , Karl Polacek , im vergangenen Jahr als gutes Beispiel revolutionärer Tat lobte , halten die Ermittler den Terrorismus-Verdacht aufrecht . 
erklaeren_s221_f1	`` Es gibt kein Gesetz , das dies zuließe '' , 	erklärt 	die AgV-Juristin . 
erklaeren_s368_f1	Um diesen Auftrag schariagemäß zu erfüllen , 	erklärte 	der oberste Richter der Republik , Ayatollah Jazdi , die vermeintlichen Rädelsführer zu Mufsid fi al-Arz , den `` Verderbern auf Erden '' . 
erklaeren_s468_f1	`` Wir haben alle Formulierungen vermieden , die irgendein Gesetz in Kuba verletzen könnten '' , 	erklärt 	mit milder Stimme Castellanoskeywordtag , `` und das hat uns dennoch nicht vor dem Rausschmiß bewahrt . '' 
erklaeren_s504_f1	`` Ich habe nicht zwanzig Jahre gerackert , um Physikprofessor zu werden und nun Toiletten zu putzen '' , 	erklärt 	Castellanoskeywordtag bestimmt . 
erklaeren_s690_f1	Der ukrainische Atomexperte Wolodymir Nikolenko 	erklärte 	, in dem Betonmantel , der das Gebäude bislang umgebe , hätten sich inzwischen Risse mit einer Gesamtlänge von 1000 Metern gebildet . 
erklaeren_s749_f1	Bereits vor Wochen hatte Jäggikeywordtag allerdings 	erklärt 	, auf Wunsch des Aufsichtsrates den Posten jederzeit zur Verfügung zu stellen . 
erklaeren_s755_f1	Politische Gefangene würden durch Schauprozesse zu gemeinen Verbrechern 	erklärt 	, hieß es . 
erklaeren_s778_f1	Lebensfähige Betriebe würden privatisiert , nicht konkurrenzfähige geschlossen , 	erklärte 	Mitsotakiskeywordtag und verschwieg auch nicht , daß sein Kurs zwangsläufig mit dem Verlust von Arbeitsplätzen verbunden sei . 
erklaeren_s963_f1	Die Regierung 	erklärte 	sich allerdings auch bereitkeywordtag , internationale Experten zur Aufklärung von Gewaltakten ins Land zu holen . 
erklaeren_s1062_f1	Noch vor kurzem hatte erkeywordtag auch Militäraktionen zum Schutz von Russen für möglich 	erklärt 	. 
erklaeren_s1137_f1	Der neue Regierungschef hat die Sanierung der Staatsfinanzen zum wichtigsten Ziel seiner Regierungsarbeit 	erklärt 	. 
erklaeren_s1260_f1	Der Führer der Rebellenbewegung Renamo , Afonso Dhlakama , 	erklärte 	sich in der botswanischen Hauptstadt Gabarone zum sofortigen Waffenstillstand bereitkeywordtag . 
erklaeren_s1355_f1	Aus welchem Land , sage ich nicht '' , 	erklärte 	Margot Honecker der Zeitung . 
erklaeren_s1509_f1	Auch die Regierung 	erklärte 	zudem ihre Entschlossenheit , die Stabilität der Landeswährung Lira zu sichern , da ein stabiler Wechselkurs im Kampf gegen die Inflation ein wesentlicher Faktor sei . 
erklaeren_s1526_f1	Man werde vor den westlichen Führern nicht in die Knie gehen , 	erklärte 	Jelzinkeywordtag vor seinen für Mittwoch geplanten Gesprächen in München . 
erklaeren_s1784_f1	Frieder Otto Wolf von der Osteuropa-Initiative Eurocom prangerte die `` intellektuelle Unredlichkeit '' der `` falschen Versprechungen '' durch die westlichen Politiker an , diekeywordtag Sozialabbau und Schließung ganzer Industrien in Osteuropa als `` unvermeidlich '' 	erklärten 	. 
erklaeren_s1977_f1	Frieder Otto Wolf von der Osteuropa-Initiative Eurocom prangerte die `` intellektuelle Unredlichkeit der `` falschen Versprechungen durch die westlichen Politiker an , diekeywordtag Sozialabbau und Schließung ganzer Industrien in Osteuropa als `` unvermeidlich 	erklärten 	. 
erklaeren_s2056_f1	Am Dienstag hatte Collorkeywordtag noch im Fernsehen 	erklärt 	, er habe 1990 , nach seinem Wahlsieg , alle Kontakte zu Farias abgebrochen . 
erklaeren_s2103_f1	Panic , dessen Staat der Ausschluß droht , 	erklärte 	in seinem am Montag den Delegationen zugeleiteten Schreiben : 
erklaeren_s2185_f1	Nach Berichten der Lissabonner Presse vom Montag 	erklärte 	der 78jährige am Vortag vor Parteimitgliedern in Sao Paio de Merelim in Nordportugal , er werde im kommenden Herbst auf dem XIV. Parteitag zurücktreten . 
erklaeren_s2287_f1	Die `` Schwierigkeiten und Spannungen '' würden wachsen , 	erklärte 	Castrokeywordtag dem Artikel zufolge . 
erklaeren_s2354_f1	Finanzminister Theo Waigel ( CSU ) hatte zuvor im Deutschlandfunk 	erklärt 	, niemand könne sagen , wie sich in den nächsten Jahren jede einzelne Steuer entwickle . 
erklaeren_s2366_f1	Süssmuthkeywordtag 	erklärte 	zu der Unterschriftenaktion , daß sachliche Überprüfung statt überzogener und pauschalierender Kritik notwendig sei . 
erklaeren_s2387_f1	Diesekeywordtag waren von der irakischen Führung für illegal 	erklärt 	worden . 
erklaeren_s2454_f1	Atomtestgebiete in Kasachstan zur Katastrophenregion 	erklärt 	
erklaeren_s2456_f1	Kasachstankeywordtag hat die Umgebung von Atomtestgeländen der früheren Sowjetunion auf seinem Territorium zu ökologischen Katastrophengebieten 	erklärt 	. 
erklaeren_s2908_f1	Zur Hauptstadt wurde das in langen Kampfhandlungen weitgehend zerstörte Mostar 	erklärt 	. 
erklaeren_s3117_f1	Rühekeywordtag 	erklärt 	britischem Kollegen deutschen Rückzieher 
erklaeren_s3339_f1	Und dazu waren am Wochenende neue Aktionen der Bauern gekommen , die sich mit den LKw-Fahrern solidarisch 	erklärten 	, in der Hoffnung , ihrer eingeschlafenen Protestbewegung gegen die Agrarpolitik der EG neuen Auftrieb zu geben . 
erklaeren_s3344_f1	`` Die Regierung weicht nicht zurück '' , hatte ein sichtlich ratloser Premierminister Pierre Bérégovoy am Sonntag in mehreren Interviews 	erklärt 	. 
erklaeren_s3492_f1	Ein Regierungsvertreter habe 	erklärt 	, daß die USA in die Putschpläne verwickelt seien . 
erklaeren_s3597_f1	Schnarrenbergerkeywordtag 	erklärte 	ferner , gegen die derzeitige deutsche Luftbrücke nach Sarajewo bestünden keine verfassungsrechtlichen Bedenken . 
erklaeren_s3647_f1	Der irakische Geschäftsträger bei der UN , Samir el Nima , hatte am Montag jedoch 	erklärt 	, das Landwirtschaftsministerium falle als zivile Einrichtung nicht unter die in den Bedingungen des Waffenstillstands genannten Institutionen . 
erklaeren_s3672_f1	Ein Kommissionsbericht werde bis Jahresende erwartet , 	erklärte 	die CDU-Politikerin . 
erklaeren_s3686_f1	Bundesbauministerin Irmgard Schwaetzer ( FDP ) 	erklärte 	dazukeywordtag , die vorgesehenen dirigistischen Eingriffe seien der Tod des freifinanzierten Wohnungsbaus , der sich gerade in den vergangenen Jahren kräftig erholt habe . 
erklaeren_s3711_f1	Am Montag hatte der Führer des neuen Kroaten-Staates , Mate Boban , 	erklärt 	, die Souveränität Bosnien-Herzegowinas werde nicht eingeschränkt . 
erklaeren_s3793_f1	Die Portugiesen hätten in einer schwierigen Zeit wesentliche Fortschritte erzielt , besonders im Bereich des Binnenmarktes , 	erklärte 	EG-Kommissar Martin Bangemann am Dienstag vor dem Europaparlament in Straßburg . 
erklaeren_s3802_f1	Das Außenministerium in Paris 	erklärte 	, die Frau des französischen Präsidenten sei privat auf Beschluß ihrer Stiftung France Libertes in Irak gewesen . 
erklaeren_s3805_f1	`` Frankreich ist der Ansicht , daß es das Klima in dieser schwierigen Region nicht zusätzlich stören sollte , indem es die Forderung der Kurden nach der Schaffung eines Staates ermutigt , der nicht den Umständen entspricht '' , hatte Mitterrandkeywordtag 	erklärt 	. 
erklaeren_s3978_f1	Waldheimkeywordtag war dort zur `` unerwünschten Person '' 	erklärt 	worden . 
erklaeren_s4040_f1	Zwickelkeywordtag hatte auf dem Gewerkschaftstag 	erklärt 	, seine Organisation sei bereit , in Westdeutschland 1997 niedrigere Einstiegslöhne für Langzeitarbeitslose hinzunehmen und sich mit einem Einkommenszuwachs in Höhe der Inflationsrate zufriedenzugeben . 
erklaeren_s4145_f1	Dort 	erklärte 	der serbische Delegationsleiter Milan Milanovic , seine Abordnung wolle zunächst intern über die Vorschläge beraten , die Stoltenberg und Galbraith überbracht hätten . 
erklaeren_s4176_f1	Das überraschende Aufholen Walesas 	erklärt 	sich Beobachtern zufolge aus der Unsicherheit vieler Wähler . 
erklaeren_s4358_f1	Dieskeywordtag 	erklärten 	die SPD-Mitglieder in der Berliner CDU/SPD-Regierung mit Ausnahme von Wirtschaftssenator Norbert Meisner nach einer Beratung am Sonntag . 
erklaeren_s4415_f1	Der Oberste Gerichtshof Rußlands hat den Ausschluß des oppositionellen Jabloko-Blocks von den Parlamentswahlen am Samstag für unrechtmäßig 	erklärt 	. 
erklaeren_s4428_f1	Nach einem Gespräch mit dem im Krankenhaus liegenden Jelzin hatte Tschernomyrdinkeywordtag am Freitag 	erklärt 	, er werde künftig die Aktivitäten der Minister der Schlüsselressorts Verteidigung , Inneres und Geheimdienste koordinieren . 
erklaeren_s4604_f1	Bundeskanzler Helmut Kohl 	erklärte 	, der feige Mord habe einen Mann getroffen , der durch großen Mut und vollen Einsatz seiner Persönlichkeit den Frieden im Nahen Osten erreichen wollte . 
erklaeren_s4721_f1	Mit diesem Beitritt , so 	erklärt 	erkeywordtag sich sein Schicksal , begannen die Probleme . 
erklaeren_s4815_f2	`` Wenn wirkeywordtag tief Luft holen , um ihnenkeywordtag zu erklären , was sie alles brauchen , haben die bereits den Rückwärtsgang eingelegt '' , weiß Nickel . 
erklaeren_s4950_f1	Den ersten Fall kann mankeywordtag wohl nur mit einem völligen Mißverständnis dessen , was Deeskalation bedeutet , 	erklären 	. 
erklaeren_s5240_f1	Wenn die Unternehmen der Metallverarbeitung garantieren , in den nächsten drei Jahren - auf betriebsbedingte Kündigungen zu verzichten , - 300 000 zusätzliche Arbeitsplätze zu schaffen , - außerdem 30 000 Langzeitarbeitslose einzustellen - sowie die Ausbildungsplätze um jährlich 5 Prozent zu steigern und wenn die Bundesregierung verbindlich 	erklärt 	, - bei der Novellierung des Arbeitsförderungsgesetzes auf die Kürzung des Arbeitslosengeldes und der Arbeitslosenhilfe zu verzichten und die Sozialhilfekriterien nicht zu verschlechtern , - eine Regelung zur Gewährleistung des Ausbildungsplatzangebotes entsprechend der Nachfrage zu schaffen , - Betriebe , die nicht oder zuwenig ausbilden , zum Lastenausgleich heranzuziehen , dann werde ich mich dafür einsetzen , - in 1997 Einkommenssteigerungen zu vereinbaren , die sich am Ausgleich der Preissteigerung orientieren , - und befristete Einarbeitungsabschläge für Langzeitarbeitslose zu ermöglichen . 
erklaeren_s5323_f1	Die Realität - das heißt abweichende Regelungen zu einigen tariflichen Bestimmungen in einer größeren Zahl vor allem mittlerer und kleinerer Betriebe - ist doch ursächlich nicht damit zu erklären , daß wir dort schlechtere Betriebsräte hätten oder in diesen Betrieben unsere Funktionäre die Grundsätze und Prinzipien unserer Organisation verraten würden . 
erklaeren_s5707_f2	`` Da müssen schon mal zehn Jahre prognostisch überbrückt werden , ehe man sich wenigstens ein Bild von der Gegenwart machen kann , auf das sich dann die mittelfristige Projektion stützen muß '' , 	erklärt 	Ifo-Forscher Josef Körner , der dem Arbeitskreis Steuerschätzung angehört , die reichlich späte Entdeckung neuer Milliardenlöcher . 
erklaeren_s5714_f1	Man wolle die Straße nicht einfach den Demonstranten der Opposition überlassen , hatte Israels Außenminister Schimon Peres noch am Vorabend der seit langem geplanten Friedensdemonstration 	erklärt 	und gut gelaunt hinzugefügt : `` Natürlich gehen wir hin '' - er und Ministerpräsident Yitzhak Rabin . 
erklaeren_s5723_f1	Um 23.15 Uhr 	erklärten 	die Ärzte offiziell den Tod . 
erklaeren_s5779_f1	Er sei zwar Mitglied dieser Gruppe , 	erklärte 	der Terrorist , habe die Tat aber `` alleine geplant und durchgeführt '' . 
erklaeren_s5893_f1	So wenig absehbar ist , wie sich die Entwicklung im Nahen Osten in den kommenden Monaten gestaltet , daß Rabin von einem Israeli ermordet wurde , ist in weiten Teilen der arabischen Öffentlichkeit mit einer Erleichterung aufgenommen worden , die man als abwegig bezeichnen müßte , wenn siekeywordtag sich nicht vor dem Hintergrund geschichtlicher Erfahrung in der Region 	erklären 	ließe : 
erklaeren_s6180_f1	`` Man kann sich von dem nicht auf der Nase herumtanzen lassen '' , hatte ÖVP-Kultursprecher Franz Morak 	erklärt 	. 
erklaeren_s6322_f1	Nach Verlusten 1994 erwartetkeywordtag Cap Gemini in diesem Jahr ein positives Ergebnis , wiekeywordtag eine Sprecherin in Paris 	erklärt 	. 
erklaeren_s6475_f1	Beide Seiten 	erklärten 	, daß aufgrund der Markt- und Wettbewerbslage `` auch Personalabbaumaßnahmen notwendig sind '' . 
erklaeren_s6506_f1	In Zagreb 	erklärte 	Präsident Franjo Tudjman , notfalls werde Ostslawonien mit Gewalt zurückgeholt . 
erklaeren_s6540_f1	Die Staatsanwaltschaft in Seoul 	erklärte 	, sie wolle in der Schweiz nach Bankkonten von Familienmitgliedern Rohs fahnden und werde eine entsprechende Anfrage an die Behörden in Bern richten . 
erklaeren_s6751_f1	Schewardnadsekeywordtag 	erklärt 	sichkeywordtag zum Wahlsieger 
erklaeren_s6753_f1	Der georgische Staatschef Eduard Schewardnadse hat sichkeywordtag am Montag zum Sieger der Präsidentenwahl in Georgien 	erklärt 	. 
erklaeren_s6767_f1	Dort hätten große Investoren den Dax verkauft , um Bestände gegen den nachgebenden Dollar abzusichern , 	erklärte 	ein Marktteilnehmer . 
erklaeren_s6794_f1	Waigelkeywordtag 	erklärte 	, über diese Frage werde man sich in den nächsten Wochen `` intensiv unterhalten '' . 
erklaeren_s7075_f2	Er hatte beim Bundesgericht in Lagos beantragt , das nigerianische Militärregime für illegal zu erklären . 
erklaeren_s7097_f1	Sokeywordtag 	erklären 	sich das `` sowohl als auch '' , das `` ja und nein '' , die sich durch das ganze Buch hindurchziehen und beim Leser zuweilen die Vorstellung wecken , der Homo Oecologicus sei ein konturloses `` alles und nichts '' . 
erklaeren_s7350_f1	Und wenn , was nicht abwegig ist , Sozialdemokraten ihre Europa-Skepsis bis zum nächsten Bundestagswahlkampf auf Touren halten , dürfte alle Welt die Berliner Republik zur Hochburg des Deutsch-Nationalen 	erklären 	. 
erklaeren_s7375_f1	Erst eine Stunde nach Schließung der Wahllokale 	erklärte 	die Spitzenkandidatin Ingrid Stahmer beleidigt : 
erklaeren_s7390_f1	Sein Parteifreund , der stellvertretende Fraktionsvorsitzende und Träger eines hohen DDR-Verdienstordens , Fritz Niedergesäß , CDU-Blockflöte seit 1958 , 	erklärt 	im Oktober 1995 : 
erklaeren_s7403_f1	Sieht man die punktuelle Zusammenarbeit zwischen CDU und PDS außerhalb Berlins , so ist es nicht überraschend , daß die Berliner CDU nach der Wahl 	erklärt 	hat , in einzelnen Berliner Bezirken auch PDS-Bürgermeister wählen zu wollen . 
erklaeren_s7638_f1	Der Attentäter 	erklärte 	dem Richter , seine Landsleute seien sich nicht bewußt geworden , daß durch Rabins Politik ein palästinensischer Staat geschaffen werde . 
erklaeren_s7640_f1	Nach Rundfunkangaben 	erklärte 	erkeywordtag weiter : `` Warum ist nun jeder schockiert über die Erschießung des Premierministers , eines Mannes , der vor aller Welt niederkniete ? 
erklaeren_s7752_f1	Die Firma , die sich als Branchenführer in Deutschland bezeichnet , 	erklärt 	ihren Erfolg unter anderem mit der engen Kooperation mit mehr als 300 Fachhändlern und der großen Fertigungstiefe . 
erklaeren_s7826_f1	In einer offiziellen Verlautbarung 	erklärte 	erkeywordtag hingegen , Polen ständen `` schwere Jahre , viele Anstrengungen und Gefahren '' bevor . 
erklaeren_s7828_f1	Führende Politiker der UW , darunter ihr Gründer Tadeusz Mazowiecki , der jetzige Vorsitzende und Wirtschaftsreformer Leszek Balcerowicz sowie der bekannte Historiker und UW-Fraktionschef Bronislaw Geremek , hatten noch am Wahlabend 	erklärt 	, daß die Partei in der zweiten Runde Lech Walesa unterstützen würde . 
erklaeren_s7830_f1	Kuron , derkeywordtag während des Wahlkampfes 	erklärt 	hatte , er würde auf keinen Fall Walesa wählen , sagte , er werde sich dem Beschluß seiner Partei fügen . 
erklaeren_s7937_f1	`` Ich würde Herrn Leister raten , sich weniger mit der Gesetzgebung als vielmehr verstärkt mit den vielen Beschwerden von Bürgern über Pannen und Unzulänglichkeiten bei der Telekom zu beschäftigten '' , 	erklärte 	Bötschkeywordtag gestern . 
erklaeren_s8199_f2	Parallel dazu lösten 140 GGLF-Delegierte ihre Organisation auf und beauftragten gleichzeitig ihren geschäftsführenden Hauptvorstand , den kollektiven Eintritt aller Mitglieder in die IG Bauen - Agrar - Umwelt zu erklären . 
erklaeren_s8212_f1	Die bisherige Regelung hatten die Karlsruher Bundesverfassungsrichter für verfassungswidrig 	erklärt 	. 
erklaeren_s8296_f2	Die Synodale zeigte sich enttäuscht , daß 50 Jahre nach dem Ende des Zweiten Weltkriegs der Bundestag keine Bereitschaft zeige , die Urteile der Militärgerichte über diese Personen als `` Unrecht von Anfang an '' zu erklären , wie dies bei Urteilen des Volksgerichtshofs geschehen sei . 
erklaeren_s8592_f1	Sprecher Peter Schlelein 	erklärte 	, mit der Vier-Tage-Woche könnten sich das zumindest die Angestellten einrichten . 
erklaeren_s8595_f1	Entgegen der langfristigen Planung 	erklärte 	der Bundestag die Woche vom 20. bis zum 24. November zur Sitzungswoche . 
erklaeren_s8703_f1	Eminkeywordtag 	erklärte 	, von Bestechung könne keine Rede sein . 
erklaeren_s8762_f1	`` Im Sinne der Anklage betrachte ich mich nicht für schuldig '' , 	erklärte 	Krenzkeywordtag . 
erklaeren_s8807_f1	Dieserkeywordtag hat im Fernsehen 	erklärt 	, er hoffe , `` daß der Nazi Arafat und sein Freund Peres auf dieselbe Weise sterben wie Rabin '' . 
erklaeren_s8988_f1	`` Wenn es wegen der Koalition nicht möglich sein sollte , die Senkung der Lohnnebenkosten schon zum 1. Januar 1996 vorzunehmen , muß es spätestens zum 1. Januar 1997 zu einer spürbaren Entlastung bei den Sozialversicherungsbeiträgen kommen '' , 	erklärte 	Lafontainekeywordtag am Dienstag in Bonn . 
erklaeren_s9089_f1	Zuvor hatte Juppékeywordtag den Rücktritt der gesamten Regierung 	erklärt 	. 
erklaeren_s9113_f1	Der Bundestag wolle Änderungen offensichtlich im Eilverfahren und ohne Beteiligung der Behindertenverbände durchführen , 	erklärte 	der BAGH-Vorsitzende Friedel Rinn am Dienstag in Düsseldorf . 
erklaeren_s9128_f2	Tests haben ergeben , daß sich Weiß davon am besten abhebt und von Autofahrern am ehesten gesehen wird '' , 	erklärt 	Bruno Frangi von der Gruppe für Rüstungsdienste in Bern die Farbwahl . 
erklaeren_s9535_f1	Ein Text , den Du kennst , 	erklärt 	diese angeborene Boshaftigkeit der Erben des Linksradikalismus . 
erklaeren_s9542_f1	Da es sich durch Dein Verschulden um ein Buch über mich handelt , möchte ichkeywordtag 	erklären 	, wie ich sehe , was ich geschrieben habe . 
erklaeren_s9641_f1	Ihr Verteidigungsexperte Jürgen Augustinowitz 	erklärte 	am Morgen in Bonn , es sei völlig unerträglich und eine Schande für die deutsche Justiz , daß das Verfassungsgericht nicht den Mut gefunden habe , das erste `` empörende Fehlurteil zu korrigieren und die Soldaten der Bundeswehr vor Ehrabschneidung zu schützen '' . 
erklaeren_s9642_f1	Verteidigungsminister Volker Rühe ( CDU ) 	erklärte 	, die Verpflichtung zum Schutz der Ehre der Soldaten werde zwar anerkannt . 
erklaeren_s9883_f1	Die beiden Mitangeklagten 	erklärten 	, sie seien bei der Tat dabeigewesen , hätten das Mädchen aber nicht vergewaltigt . 
erklaeren_s9891_f1	US-Verteidigungsminister William Perry hatte vergangene Woche in Tokio 	erklärt 	, er sei bereit , einzelne Truppenteile aus Okinawa abzuziehen und an andere japanische Orte zu verlegen - insgesamt müsse es jedoch bei der Präsenz von 47 000 US-Soldaten in Japan bleiben . 
erklaeren_s9941_f1	Sollte Peres jedoch scheitern , dann könnte der Präsident einen zweiten Politiker mit der Regierungsbildung beauftragen , 	erklärte 	Dromikeywordtag . 
erklaeren_s10106_f1	Der Gesamtmetall-Vorstand 	erklärte 	sich bereitkeywordtag , mit der IG Metall über das von Zwickel vorgeschlagene `` Bündnis für Arbeit '' zu reden . 
erklaeren_s10194_f1	Was die Bundesverfassungsrichter entschieden haben , ist auch für Andersdenkende nachvollziehbar und 	erklärt 	Bundeswehrsoldatenkeywordtag mitnichten zu Vogelfreien . 
erklaeren_s10319_f1	`` Es kann keine Rede davon sein , daß Washington sich Lubbers widersetzt '' , 	erklärte 	tapfer das niederländische Außenministerium . 
erklaeren_s10557_f1	Der Kaufmann 	erklärte 	erneut , er habe das radioaktive Material von einem Schweizer Geschäftsmann als Stoff zur Metallveredelung erhalten . 
erklaeren_s10560_f1	Der Stoff , den er von dem Schweizer erhalten habe , sei nicht identisch mit dem Gemisch , das in seiner Garage gefunden worden sei , 	erklärte 	erkeywordtag . 
erklaeren_s10638_f1	Mehrere Befürworter der Oppositionsrolle 	erklärten 	dagegen , die SPD dürfe sich nicht wie die FDP in Bonn als Mehrheitsbeschaffer mißbrauchen lassen . 
erklaeren_s10641_f1	Der Vorsitzende des SPD-Kreisverbandes Wedding , Hans Nisble , 	erklärte 	seinen Rücktritt aus dem Landesvorstand zum Ende des Parteitages und übte heftige Kritik an der Parteiführung und Spitzendkandidatin Stahmer . 
erklaeren_s10699_f1	Bisher habe sich nur Bayern dagegen ausgesprochen , 	erklärte 	siekeywordtag . 
erklaeren_s10946_f1	SPD-Spitzenkandidatin Ingrid Stahmer 	erklärte 	, die SPD könne eine aktive Politik nur innerhalb einer Regierung verwirklichen . 
erklaeren_s11096_f1	Das ist eine Sache Deutschlands '' , 	erklärte 	Turnoffkeywordtag . 
erklaeren_s11230_f1	Weiter heißt es in dem Brief : `` Beschämt und verwirrt , voll Trauer und das Haupt bedeckt in Schande erbitten wirkeywordtag Vergebung von Frau Rabin , ihrer Familie und dem ganzen israelischen Volk und 	erklären 	, daß wir Anstoß nehmen an jedweder Gewalt . '' 
erklaeren_s11328_f1	Parallelisierungen wechseln mit erhellenden Konfrontationen , ein Bild `` 	erklärt 	'' das andere ( besser ) . 
erklaeren_s11454_f1	Ich glaube , daß ichkeywordtag gerade hier auf deutschem Boden nicht allzu lange 	erklären 	muß , wie leicht ein Mensch einem solchen Dämon der Selbstdefinierung aufgrund seiner Stammeszugehörigkeit unterliegen kann und welches Unheil und welche Schrecken dies letzten Endes verursachen kann . 
erklaeren_s11511_f5	Indem sie sich salonfähig präsentiere , 	erklärt 	ein Mitarbeiter vom Fonds zur Erforschung der gesellschaftlichen Meinung die guten Umfrageergebnisse , sei die KPRF heute auch für `` nichtkommunistische Unzufriedene '' wählbar . 
erklaeren_s11638_f1	Wie 	erklärt 	es sich , daß so viele Erwachsene ihren Mathematikunterricht als verschwendete Zeit ansehen und daß die Leistungsfähigkeit selbst bei den einfachsten arithmetischen Problemen oft genug erbärmlich ist ? 
erklaeren_s12060_f1	Ulmanis , laut Verfassung nur für die Ernennung des Regierungsbildners zuständig , 	erklärte 	jedoch öffentlich , er werde niemals zustimmen , daß `` der Extremist Siegerist '' einen Kabinettsposten erhalte . 
erklaeren_s12292_f1	Weder der realitätsleere logische Positivismus von Oxford noch der heutige Sprachspiel-Dekonstruktivismus können ja 	erklären 	, warum wir uns überhaupt die Mühe der Theoriebildung machen . 
erklaeren_s12771_f1	Sie richte sich nun an die Einzelstaaten , 	erklärt 	der EBG . 
erklaeren_s12784_f1	Vielekeywordtag befragtekeywordtag Jugendlichekeywordtag hätten selbst 	erklärt 	, sie fühlten sich nicht reif genug . 
erklaeren_s12918_f1	Zwar verhalte sich die Mehrheit der Gesellschaften ordnungsgemäß , 	erklärt 	BAV-Sprecherin Elke Washausen-Richter . 
erklaeren_s13074_f1	Daß sich das Landratsamt dazu entschieden hat , die Verursacherin heranzuziehen , sei nicht zu beanstanden , 	erklärten 	die Richter des 10. Senats . 
erklaeren_s13166_f1	Zwei Geiseln seien nach Angaben der Entführer leicht erkrankt , würden aber behandelt , 	erklärte 	ein Behördensprecher . 
erklaeren_s13173_f1	Siekeywordtag 	erklärten 	unmittelbar nach dem Beschluß des zuständigen Bundesrichters William Turnoff am Mittwoch in Miami , damit werde sich das Verfahren in den USA noch mehrere Monate lang hinziehen . 
erklaeren_s13198_f1	Anschließend 	erklärten 	siekeywordtag , sie stimmten darin überein , daß ihre gegensätzlichen Positionen nicht in Einklang zu bringen seien . 
erklaeren_s13212_f1	Die Kirchen hätten ausdrücklich gefordert , daß Leistungen für die sozial Schwachen wie Langzeitarbeitslose von Kürzungen ausgenommen bleiben müßten , 	erklärte 	der Sozialwissenschaftler in einem vorab veröffentlichten Beitrag der am Sonntag erscheinenden nord- und ostdeutschen Kirchenzeitungen . 
erklaeren_s13247_f1	Die Informationsquelle sei offenkundig im Ministerium zu suchen , 	erklärte 	der Abgeordnete . 
erklaeren_s13360_f1	Der Generalsekretär des Commonwealth , der ehemalige nigerianische Außenminister Chief Emeka Anyaoku , 	erklärte 	in einer schriftlichen Stellungnahme : `` Ich wiederhole meine von Herzen kommende Bitte , daß die nigerianische Regierung Gnade walten läßt . '' 
erklaeren_s13413_f1	Unterdessen 	erklärten 	Teilnehmer der Konferenz in den USA , der Jugoslawien-Gipfel in Ohio stehe kurz vor einem erfolgreichen Abschluß . 
erklaeren_s13524_f1	Weder sei die Übertragung von Immobilien auf Geldhäuser im Westen im Kaufpreis für einzelne DDR-Institute oder Aktien vernachlässigt worden , noch hätten die Gläubigerbanken zweifache Zinsleistungen erhalten , 	erklärt 	das Ressort in ersten Antworten auf 18 parlamentarische Fragen der Sozialdemokraten . 
erklaeren_s13563_f1	Auch die britische Regierung hatte in der vergangenen Woche 	erklärt 	, sie bleibe bei ihrem Einreiseverbot für Mun . 
erklaeren_s13564_f1	Innenminister Michael Howard hatte dazukeywordtag 	erklärt 	, der Sektenführer sei in Großbritannien unerwünscht , da die von seiner `` Vereinigungskirche '' geforderte Trennung der meist jugendlichen Anhänger von ihren Familien großen Schaden anrichte . 
erklaeren_s13571_f1	Der World Wide Fund For Nature ( WWF ) 	erklärte 	am Mittwoch in Genf , den Elefanten in Asien drohe innerhalb von 50 Jahren das Aussterben , wenn nicht etwas für ihren Schutz getan würde . 
erklaeren_s13624_f1	Er verzichte auf eine Kandidatur für jegliches politische Amt , da er nicht die Berufung für ein politisches Leben verspüre , 	erklärte 	Powell - er ist der erste Schwarze an der Spitze der US-Streitkräfte - zur Begründung seiner Entscheidung am Mittwoch auf einer Pressekonferenz in Alexandria bei Washington . 
erklaeren_s13715_f1	`` Dieser Sozialstaat läßt Hilfsbedürftige nicht im Stich '' , 	erklärte 	Blümkeywordtag . 
erklaeren_s13986_f1	Als die amerikanischen Gläubiger die Begleichung eines Kredits in Höhe von 297 Millionen Kronen verlangten , mußte die Werft sichkeywordtag für zahlungsunfähig 	erklären 	. 
erklaeren_s14496_f1	Damit werden jedoch weder die Beschwerdeführer freigesprochen noch Kränkungen einzelner Soldaten oder der Angehörigen bestimmter Streitkräfte durch Äußerungen wie `` Soldaten sind Mörder '' für zulässig 	erklärt 	. 
erklaeren_s14599_f1	Siekeywordtag muß dann jedesmal mühsam 	erklären 	, daß die EU nicht die Kompetenzen habe , die man ihr allgemein zutraue - das Parlament schon gar nicht . 
erklaeren_s14685_f1	Die Pressestelle der Heidelberger Polizei 	erklärte 	, Deckert sei gegenüber den Beamten `` in der für ihn typischen Art ausfallend geworden '' . 
erklaeren_s14963_f1	Dieserkeywordtag 	erklärte 	, das Formular sei `` mißverständlich formuliert '' gewesen . 
erklaeren_s14969_f1	Kwasniewskikeywordtag hatte zunächst 	erklärt 	, er könne sich nicht erinnern , ob er die Aktien angegeben habe . 
erklaeren_s14974_f1	Erkeywordtag 	erklärte 	zur Überraschung seiner Landsleute , daß er und seine Familie seit fünf Jahren von einer Million Dollar leben , die er für Filmrechte kassierte . 
erklaeren_s15052_f1	Beide setzen auf eine `` Wegelenkung '' , auf Zonierungen sowie räumliche und zeitliche Beschränkungen etwa in Brut- , Rast- oder Mauserzeiten von Wasservögeln , deren Sinn dem Menschen nachvollziehbar 	erklärt 	werden müßten . 
erklaeren_s15154_f1	Er sei `` ein überzeugender Kandidat '' , 	erklärte 	der FDP-Vorsitzende Wolfgang Gerhardt am Donnerstag in Gegensatz zu Bundeskanzler Helmut Kohl ( CDU ) , der Sympathie für den niederländischen Bewerber Ruud Lubbers erkennen ließ . 
erklaeren_s15220_f2	Als Auflösung des Arbeitsvertrages müßten auch Vereinbarungen verstanden werden , in denen sich der Arbeitnehmer ( etwa gegen Zahlungen ) mit einer Kündigung einverstandenkeywordtag 	erklärt 	und deshalb `` am Ende des Beschäftigungsverhältnisses mitwirkt '' . 
erklaeren_s15246_f1	Mit der jetzigen Entscheidung wird aber festgestellt , daß nicht nur der klassische Aufhebungsvertrag zu einer Sperre des Arbeitslosengeldes führen kann , sondern daß auch `` Vereinbarungen '' , die neben einer offiziellen Kündigung getroffen wurden und in denen sich der Mitarbeiter ( meist gegen Zahlung seitens des Arbeitgebers ) mit der Kündigung einverstandenkeywordtag 	erklärt 	, als Auflösung des Arbeitsverhältnisses gelten können . 
erklaeren_s15258_f3	Das Hessische Landessozialgericht hatte die Sperrzeit für unzulässig 	erklärt 	: 
erklaeren_s15351_f1	Wenn die Europaabgeordneten die Verhältnisse in der Türkei unvoreingenommen betrachteten , müßten sie zu dem Ergebnis kommen , daß ihr Land die Zollunion verdient habe , 	erklärte 	Cillerkeywordtag . 
erklaeren_s15372_f1	unser Land war auf dem Tiefpunkt seiner Geschichte angekommen '' , 	erklärte 	Kinkelkeywordtag in Bonn . 
erklaeren_s15395_f1	wegen der `` Gewalt , die unsere Beschäftigten dort unten erfahren mußten '' , wiekeywordtag eskeywordtag ein Shell-Sprecher der FR 	erklärte 	. 
erklaeren_s15503_f1	Wie 1940 , als de Gaulle sich weigerte , die Niederlage Frankreichs zu akzeptieren , und die Franzosen von London aus zum Widerstand gegen Deutschland aufrief , komme es jetzt darauf an , `` Entmutigung , Konformismus und Resignation zurückzuweisen '' , 	erklärte 	Chirackeywordtag . 
erklaeren_s15602_f1	Anfang der 90er Jahre , als der angesehene Bürgermeister seinen Kämmerer beiseite schob und sich selbst für alle Geldgeschäfte zuständig 	erklärte 	, war Neckarwestheim nicht nur schuldenfrei , sondern hatte als reichste Gemeinde in ganz Baden-Württemberg schon rund 40 Millionen Mark auf der hohen Kante . 
erklaeren_s15653_f1	BKA-Sprecher Gerhard Schlemmer 	erklärte 	dagegen erneut , die Wiesbadener Kriminalbehörde habe keine originäre Zuständigkeit im Kampf gegen solche Verbrechergruppen . 
erklaeren_s15661_f2	Sokeywordtag 	erklärt 	Klaus Kinkel , weshalb er für den 15. und 16. November zu einer großen Konferenz unter dem Motto `` Europa und die islamische Welt '' in Bonn eingeladen hat . 
erklaeren_s15677_f1	Kinkelkeywordtag 	erklärt 	von sich aus , weshalb auch der iranische Außenminister Ali Akbar Welayati geladen ist . 
erklaeren_s15940_f1	In extremen Fällen könne es zu einer Überhitzung des Motors kommen , 	erklärte 	Seatkeywordtag am Freitag in Barcelona . 
erklaeren_s16148_f1	Daraufhin habe Lubberskeywordtag 	erklärt 	, er stehe nicht mehr als Kandidat zur Verfügung . 
erklaeren_s16213_f1	Die Demokraten im Senat 	erklärten 	, die republikanische Mehrheit wolle Clinton mit der drohenden Zahlungsunfähigkeit erpressen . 
erklaeren_s16250_f1	`` Schneeballgleich hat sich eine Lawine entwickelt , die an Dramatik immer weiter zunahm '' , 	erklärte 	erkeywordtag vor Gericht . 
erklaeren_s16337_f1	Die Erhöhung der Kreditlinie der Hamburgischen Landesbank für die Gesellschaft auf 174 Millionen Mark sei mit dem europäischen Stahlbeihilfenkodex nicht vereinbar , 	erklärt 	Brüsselkeywordtag . 
erklaeren_s17204_f2	Kann mankeywordtag daskeywordtag 	erklären 	? 
erklaeren_s17601_f1	Doch der Dichter 	erklärt 	auch , damit seiner Zeit gewiß voraus , wie dies gekommen ist : 
erklaeren_s18022_f1	Ich kann dazu nichts sagen '' , 	erklärte 	der verantwortliche IFC-Projektleiter Osman Shahansha . 
erklaeren_s18399_f1	Der schweizerische Führerschein wurde mit einem Stempel für ungültig 	erklärt 	. 
erklaeren_s18551_f5	Man selbst , 	erklärt 	Constantin von Brandenstein , Präsident des Malteser-Hilfsdienstes das Engagement der Beteiligten , sei zwar eine `` rasende Minderheit '' , doch stecke `` in den Menschen auch in der heutigen Gesellschaft eine ganz große Hilfsbereitschaft '' , wenn auch latent . 
erklaeren_s18589_f1	Dem `` Kettensägen-König '' den Krieg 	erklärt 	
erklaeren_s18763_f1	Es sei `` ein unglücklicher Vorgang für die Menschenrechte '' , daß der Preis an eine Person gegangen sei , der die Gerichte Verbindungen zu einer Terrororganisation nachgewiesen hätten , 	erklärte 	ein Sprecher des türkischen Außenministeriums in Ankara . 
erklaeren_s18774_f1	Die sozialistische Europaabgeordnete Pauline Green 	erklärte 	, die Preisverleihung sei `` ein unmißverständliches Signal an die Regierung in Ankara '' . 
erklaeren_s18910_f1	Es sei `` ein unglücklicher Vorgang für die Menschenrechte '' , daß der Preis an eine Person gegangen sei , der die Gerichte Verbindungen zu einer Terrororganisation nachgewiesen hätten , 	erklärte 	in Ankara ein Sprecher des türkischen Außenministeriums . 
erklaeren_s18912_f1	Leyla Zana sei stellvertretend für alle Kurden , die um Frieden und Freiheit kämpfen , geehrt worden , 	erklärte 	der Vorsitzende des türkischen Menschenrechtsvereins ( IHD ) , Akin Birdal . 
erklaeren_s18922_f1	Diekeywordtag sozialistische Euro-Abgeordnete Pauline Green 	erklärte 	, die Preisverleihung sei `` ein klares und unmißverständliches Signal an die Regierung in Ankara '' . 
erklaeren_s18935_f1	Was Geschäftsinteressen selbst auf dem Hintergrund amerikanisch-europäischer Konkurrenz mit dem notwendigen Dialog der Religionen zu tun haben , soll der katholische deutsche Außenminister unskeywordtag erst einmal unjesuitisch 	erklären 	. 
erklaeren_s19094_f2	Bundesinnenminister Manfred Kanther ( CDU ) hat das Bundesverfassungsgericht in Karlsruhe davor gewarnt , Teile des neuen Asylrechts für verfassungswidrig zu erklären . 
erklaeren_s19300_f1	Während die Regierung in Den Haag freudig 	erklärte 	, nun sei ihr Mann offizieller Kandidat , ließ die Führungsmacht wissen , dieser habe `` bei uns niemanden beeindruckt '' . 
erklaeren_s19351_f1	Ulrich Irmer , außenpolitischer Sprecher der FDP-Fraktion , 	erklärte 	, man melde sich aus der Politik ab , wenn man nicht versuche , `` mit den Schlimmsten zu reden '' . 
erklaeren_s19408_f1	Wenn der CDU-Politiker den inneren Frieden in diesem Land schon deswegen als bedroht bezeichnet , weil die Richter einige der Asyl-Bestimmungen für verfassungswidrig 	erklären 	könnten ; wenn der Minister jede kleine Korrektur an den Gesetzen quasi mit ihrer Zerschlagung gleichsetzt ; wenn der Christdemokrat selbst die drastisch gesunkenen Flüchtlingszahlen noch immer als riesiges Problem darstellt ; und wenn Kanther im Hinblick auf die Anhörung des Gerichts eine dramatisierende Formulierung an die andere reiht : Dann kann man das wohl kaum anders als politischen Druck auf die Karlsruher Richter nennen . 
erklaeren_s19413_f1	Diese und andere Defizite im neuen Asylrecht muß das Bundesverfassungsgericht für verfassungswidrig 	erklären 	. 
erklaeren_s19453_f1	Das britische Außenministerium 	erklärte 	, mit den Hinrichtungen habe Nigeria gegen seine Verpflichtung aus internationalem Recht verstoßen , faire Prozesse und ein Recht auf Berufung zu gewähren . 
erklaeren_s19586_f1	Eine Entscheidung gibt es aber noch nicht '' , 	erklärt 	ein VW-Sprecher . 
erklaeren_s20026_f1	Für `` Schwachsinn '' hat etwa der Filmemacher Edgar Reitz die Pläne 	erklärt 	, in Straßburg künftig ein europäisches Filmfestival etablieren und mit der Felix-Vergabe krönen zu wollen . 
erklaeren_s20328_f1	Kohlkeywordtag hat Chinakeywordtag zur Chefsache 	erklärt 	. 
erklaeren_s20530_f1	Nelson Mandela 	erklärte 	, er habe `` ein reines Gewissen - 
erklaeren_s20820_f1	Die ehemalige SPD-Spitzenkandidatin Ingrid Stahmer 	erklärte 	, ein schonungsloser `` Kassensturz '' sei Voraussetzung für alle weiteren Überlegungen . 
erklaeren_s20878_f1	SPD-Präsidiumsmitglied Gerhard Schröder , dem diese Sätze offenbar galten , 	erklärte 	sich bereitkeywordtag , in Scharpings Team wieder mitzuwirken . 
erklaeren_s20919_f1	Außenminister Tom Ikimi 	erklärte 	auf einer Pressekonferenz in Auckland mit Bezug auf die Aussetzung der Mitgliedschaft seines Landes im Commonwealth , Nigeria sei ein `` friedliebendes und verantwortungsbewußtes '' Land , das eine bessere Behandlung verdient habe . 
erklaeren_s20921_f1	Das Commonwealth habe sich in die internen Angelegenheiten seines Landes eingemischt und überhastet gehandelt , ohne die Fakten zu kennen , 	erklärte 	Ikimi , der von den weiteren Beratungen ausgeschlossen worden war . 
erklaeren_s21356_f1	Wiekeywordtag Sprecher der SPD-geführten Regierungen in Nordrhein-Westfalen , Hessen , Schleswig-Holstein , Hamburg und dem Saarland 	erklärten 	, sollenkeywordtag bis auf weiteres nigerianische Asylsuchende nicht mehr gezwungen werden , die Bundesrepublik zu verlassen . 
erklaeren_s21458_f1	Die Verfassungsrichter hatten die Verwendung des Tucholsky-Zitats für zulässig 	erklärt 	, wenn nicht einzelne Soldaten als `` Mörder '' bezeichnet würden , sondern das Soldatentum an sich gemeint ist . 
erklaeren_s21613_f1	Der baden-württembergische FDP-Vorsitzende Walter Döring 	erklärte 	, er halte es für völlig unmöglich , daß 40 Abgeordnete der Regierungsparteien Kinkel und die Koalition in große Schwierigkeiten gebracht hätten . 
erklaeren_s21639_f1	Die starke Aufwertung der Mark und die hohen Tarifabschlüsse hätten diese Hoffnung zerstört , 	erklären 	die `` Weisen '' nun . 
erklaeren_s22068_f1	doch war das offenbar nur Tarnung für die vielen Italienern der älteren Generation unangenehmen Wahrheiten wie die , daß es über die italienischen Kriegstaten vor dem 8. September 1943 große Lücken gibt , während Untersuchungen über den Widerstand , diekeywordtag Italienkeywordtag zu einer Art Sieger des Krieges 	erklären 	, ganze Bibliotheken füllen . 
erklaeren_s22305_f1	Ein Sprecher des südkoreanischen Außenministeriums 	erklärte 	: `` Wir sind geschockt und verärgert über dieses verzerrte Geschichtsbild eines japanischen Politikers . '' 
erklaeren_s22564_f1	Fast genauso viele 	erklären 	, sie würden vom Staat unterstützt . 
erklaeren_s22741_f2	`` Einzelne Mitgliedsstaaten haben in den zurückliegenden Jahren erklärt , sie seien zur Zeit nicht zu einer Einführung der Steuer bereit '' , 	erklärt 	Repnikkeywordtag . 
erklaeren_s22998_f1	Obwohl die Ergebnisse aus den ländlichen Provinzen noch fehlten , 	erklärte 	sichkeywordtag Arzukeywordtag bereits zum Sieger . 
erklaeren_s23030_f1	Der Regierungschef hatte am Sonntag im britischen Fernsehen 	erklärt 	, er erwarte sich `` Erläuterungen '' Shells zu der geplanten Fabrik : 
erklaeren_s23301_f1	Daskeywordtag 	erklärte 	Grünen-Sprecherin Anne Nilges am Dienstag in Bonn nach einem Treffen des DGB-Vorsitzenden Dieter Schulte und weiterer führender Gewerkschafter mit Spitzenpolitikern aus Partei und Bundestagsfraktion der Bündnisgrünen . 
erklaeren_s23312_f1	Der Volkspolizist habe nach zwei Warnschüssen aus acht Metern Entfernung gezielt auf den Flüchtenden geschossen und ihn tödlich getroffen , 	erklärte 	die Staatsanwaltschaft . 
erklaeren_s23355_f1	Der Schauspieler Robert Meyer hat in einem offenen Brief an Direktor Claus Peymann seinen Rücktritt als Mitglied und Sprecher der Vertretung des Ensembles 	erklärt 	. 
erklaeren_s23383_f1	Der Bund hat sich bereitkeywordtag 	erklärt 	, zu den bis Ende 1996 aufgelaufenen Schulden und Zinsen in Höhe von rund 8,7 Milliarden Mark rund eine Milliarde Mark beizusteuern . 
erklaeren_s23393_f1	Die Hochschulrektorenkonferenz ( HRK ) wird keine Forderung nach einer Einführung von Studiengebühren verabschieden , 	erklärte 	ihr Präsident Hans-Uwe Erichsen . 
erklaeren_s23453_f1	Erkeywordtag identifizierte Nilakout vor Gericht als Täter und 	erklärte 	, er hoffe auf die Todesstrafe . 
erklaeren_s23502_f1	`` Wir bei IBM wetten unsere Zukunft darauf , daß aus dem Personal-Computer ein Interpersonal-Computer wird '' , 	erklärte 	der Chef des EDV-Konzerns , Louis Gerstner , zur Eröffnung der Branchenmesse Comdex in Las Vegas . 
erklaeren_s23646_f1	Anschließend habe mankeywordtag 	erklärt 	, Semestergebühren könnten nur ein letztes Mittel sein . 
erklaeren_s23723_f1	Die Wahl solle lediglich eine `` Diktatur '' legitimieren , 	erklärten 	die Oppositionellen übereinstimmend . 
erklaeren_s23727_f1	Der große Andrang der etwa 730 000 Auslandsalgerier , die bereits am Samstag mit der Stimmabgabe begonnen hatten , wurde ebenfalls mit Repression 	erklärt 	. 
erklaeren_s23888_f1	Der Präsident der Hochschulrektorenkonferenz , Hans-Uwe Erichsen , 	erklärte 	am Dienstag in Bonn , Semestergebühren könnten nur das letzte Mittel gegen die Finanzmisere an den Hochschulen sein . 
erklaeren_s23895_f1	Als die Universität Passau 1978 gegründet wurde , 	erklärte 	mankeywordtag die `` Maria im Siege '' einfach zur Symbolfigur des Wissenschaftsbetriebes . 
erklaeren_s24094_f1	Beispielhaft für viele 	erklärt 	Minister Rüttgers die ökologischen Vorteile der Informationsgesellschaft damit , Telearbeit könne den Berufsverkehr ebenso merklich ausdünnen wie Videokonferenzen die Dienstreisen . 
erklaeren_s24370_f1	`` Wir konzentrieren uns auf Marktnischen , in denen wir schneller sein können als die Telekom '' , 	erklärt 	Deutschland-Chef Horst Enzelmüller . 
erklaeren_s24767_f1	Der `` Hevalti '' -Vorstand kündigte Rechtsmittel gegen das Verbot an und 	erklärte 	, die Vorwürfe beträfen nicht den Verein als solchen . 
erklaeren_s24849_f1	Eto war unter Druck geraten , weil erkeywordtag 	erklärt 	hatte , die japanische Herrschaft über Korea zwischen 1910 und 1945 habe auch `` ihre guten Seiten '' gehabt . 
erklaeren_s24940_f1	Die Gesamthöhe der Provisionen werde durch die kostenlosen Schulungen und die garantierten Zahlungen nicht gekürzt , 	erklärt 	Maschmeyerkeywordtag . 
erklaeren_s24953_f1	Um dies umzusetzen , müssen allerdings die hiesigen Tarifregelungen für allgemeinverbindlich 	erklärt 	werden . 
erklaeren_s24962_f1	Mit der konjunkturellen Abkühlung sei diese Entwicklung nicht zu erklären . 
erklaeren_s25105_f1	Die WTO 	erklärt 	dieses Phänomen mit technischen Innovationen , welche die Kommunikations- und Transportkosten verringerten und damit den grenzüberschreitenden Austausch erleichterten . 
erklaeren_s25219_f1	Das Thema werde von `` manchen Befürwortern einer Flexibilisierung der Ladenschlußzeiten zu einer Symbolfrage für Anpassungsfähigkeit und Beweglichkeit '' hochstilisiert , 	erklärte 	Bohlkeywordtag und fuhr fort : 
erklaeren_s25613_f1	Geduldig muß ein Wachmann dem empörten Touristen die Finanznöte der Bundesregierung 	erklären 	. 
erklaeren_s25730_f1	Die sogenannte modifizierte Zugewinngemeinschaft berücksichtige die Interessen beider Partner besser als die von Laien oft pauschal empfohlene Gütertrennung , 	erklärten 	die Rheinischen Notare in Köln stellvertretend für vier deutsche Notarkammern . 
erklaeren_s25918_f1	Der französische Wirtschafts- und Finanzminister Jean Arthuis 	erklärte 	, er schließe Sanktionen gegen Teilnehmer des Geldverbundes , die die Stabilitätskriterien verletzen , nicht aus . 
erklaeren_s26023_f1	Das Paket könnte an private Investoren gehen , 	erklärt 	Vorstandssprecher Wolfgang Steinriede . 
erklaeren_s26050_f1	Es gebe keinen Grund die Sätze zu senken , da sich die wichtigsten Daten der Volkswirtschaft nicht geändert hätten , 	erklärte 	Thomas Mayer , Chefökonom bei Goldman Sachs in Frankfurt . 
erklaeren_s26363_f1	Sokeywordtag 	erklären 	sich wohl , neben Vorzügen , auch die Schwächen der Montessori-Pädagogik . 
erklaeren_s26495_f1	Es gibt eine große Freundlichkeit zwischen den Leuten und gleichzeitig viel Gewalt , eskeywordtag ist nicht zu 	erklären 	. 
erklaeren_s26627_f1	Von heute her 	erklärt 	sich manche Facette des ungeheuren Gouldschen Nachruhms . 
erklaeren_s26894_f1	Das UN-Tribunal hatte am Dienstag die Auslieferung des 39jährigen Serben aus Deutschland für rechtmäßig 	erklärt 	. 
erklaeren_s27053_f2	Die Differenz 	erklärt 	sich im wesentlichen durch die Rückgabe von Rentenfonds-Zertifikaten . 
erklaeren_s27078_f1	Jede Wahlurne ein Sarg '' , 	erklärte 	siekeywordtag . 
erklaeren_s27314_f1	`` Wir müssen weiter restrukturieren '' , 	erklärt 	der Manager , `` und das Thema wird uns über den ganzen Zeitraum begleiten , in dem wir jetzt denken . '' 
erklaeren_s27434_f1	Das Fehlverhalten von Mitarbeitern des Reviers Mitte 	erklärt 	sich Dresslerkeywordtag so : Der ständige Umgang mit Randgruppen habe möglicherweise `` abgefärbt '' und die Achtung vor dem Nächsten gelitten . 
erklaeren_s27439_f1	Damit erhofft man sich den rüden Ton unter Männern abzumildern , 	erklärte 	der Polizeisprecher . 
erklaeren_s27584_f1	Am Vortag hatte erkeywordtag nach dem Abschluss des Treffens der Westeuropäischen Union in Madrid 	erklärt 	, es liege nicht an ihm , die Frage nach seiner Kandidatur zu beantworten . 
erklaeren_s27775_f2	`` Wehrpflicht glaubwürdig zu erhalten , heißt also zu erklären , weshalb wir sie trotz des Wegfalls der unmittelbaren äußeren Bedrohung immer noch benötigen '' , sagte der Bundespräsident . 
erklaeren_s27798_f1	Es lasse sich aber vielmehr belegen , daß sie in Wahrheit `` im Prinzip rational auf das reagieren , was ihnen widerfahren ist '' , 	erklärte 	van Dijk . 
erklaeren_s28053_f1	Auch Scharping selbst 	erklärte 	, daß er kandidieren wolle . 
erklaeren_s28067_f1	CDU-Generalsekretär Peter Hintze 	erklärte 	, mit der Wahl Lafontaines verlasse die SPD die politische Mitte . 
erklaeren_s28094_f1	Der Vorsitzende des Arbeitsrings , Rainer Guski , 	erklärte 	: `` Die Studie belegt , daß 2000 bis 3000 tödlich verlaufende Herzinfarktfälle jährlich vermieden werden könnten , wenn die Belästigung durch Verkehrslärm auf unter 65 Dezibel ( A ) gesenkt werden könnte . '' 
erklaeren_s28100_f1	Der BUND 	erklärte 	, Dauerlärm bedeute auch Dauerstreß . 
erklaeren_s28104_f1	Guskikeywordtag 	erklärte 	, bundesweit fühlten sich 75 Prozent der Bürger durch Lärm belästigt . 
erklaeren_s28136_f1	Das Endlager unterliege der Eigenaufsicht des Bundes , 	erklärte 	das Gericht . 
erklaeren_s28153_f1	Der deutsche PEN-Club will den von islamistischen Organisationen mit dem Tode bedrohten ägyptischen Literaturwissenschaftler Nasr Hamed Abu Zaid und seine Frau zu Ehrenmitgliedern 	erklären 	. 
erklaeren_s28156_f1	Der Richter war dem Antrag islamistischer Anwälte gefolgt , diekeywordtag Abu Zaid wegen seiner Schriften zum Ungläubigen 	erklären 	lassen wollten . 
erklaeren_s28221_f1	Neben Jones 	erklärte 	sich auch einer der zwei als Mittäter verdächtigten Männer , Alvin Hudson ( 22 ) , zu einem Geständnis bereitkeywordtag . 
erklaeren_s28315_f1	Der Parteigründer der rechtsextremistischen Republikaner hat seinen Austritt aus der Partei 	erklärt 	. 
erklaeren_s28322_f1	Der `` Marsch in den rechten Fundamentalismus '' sei ein Irrweg , 	erklärte 	Schliererkeywordtag in Stuttgart . 
erklaeren_s28551_f1	Der BASF-Sprecher 	erklärt 	, ein Verdacht gegen sein Unternehmen sei unbegründet . 
erklaeren_s28910_f1	Nachdem er eine Mitarbeit in der Regierung bisher stets auf die Zukunft vertagt hatte , 	erklärte 	erkeywordtag sich jetzt erstmals zur Kanzlerschaft bereitkeywordtag , sollte die FPÖ die Wahl im Dezember doch noch gewinnen . 
erklaeren_s29023_f1	Zu Hause muß ichkeywordtag immer 	erklären 	, daß wir zwar souverän , aber klein sind '' : 
erklaeren_s29243_f1	Ein Berliner Problem : Jedem zweiten Taxifahrer müssen Siekeywordtag 	erklären 	, wo die Theater liegen . 
erklaeren_s29273_f1	Übrigens hat erkeywordtag ja 	erklärt 	, daß ich , käme er an die Macht , sofort entlassen würde . 
erklaeren_s29311_f1	Um den gesetzlichen Anspruch einzulösen , müßten neue Rehabilitationsangebote geschaffen werden , 	erklärte 	der Referatsleiter des Ministeriums . 
erklaeren_s29313_f1	`` Wir warten nur auf Konzepte '' , 	erklärte 	Pettrichkeywordtag . 
erklaeren_s29318_f1	Auch die Bereitschaft der Hausärzte , den über 60jährigen Ergo- und Logotherapie zu verordnen , sei gering , 	erklärte 	Pettrichkeywordtag . 
erklaeren_s29339_f1	Nicht nur jene der Institute , von denen er in Düsseldorf schon zwei für zusammenlegungsfähig hält , nur weil sichkeywordtag deren Leiter für vorruhestandsreif 	erklären 	. 
erklaeren_s29479_f1	Dengs Antwort , mit der er sich in der Parteiführung durchsetzte , ist bekannt , wenn auch meistens falsch 	erklärt 	. 
erklaeren_s29537_f1	Siekeywordtag 	erklären 	die heimische Flora und Fauna . 
erklaeren_s30017_f1	Nur mit aus Überheblichkeit geborenem Leichtsinn kann 	erklärt 	werden , daß Gingrich zu alledem auch noch Steuergeschenke an die Wohlhabenden geben will . 
erklaeren_s30025_f1	Während Gingrich und seine Leute wie fleißige Buchhalter Seite um Seite eines Haushaltes nach ihrem Gusto berechneten und mit einem zweibändigen , voluminösen Werk endeten , reiste Clinton durchs Land und tat das , was er am besten kann , erkeywordtag sprach mit den Leuten und 	erklärte 	ihnenkeywordtag , daß sanfte Reformen nach seiner Art besser sind , als `` Revolutionen '' à la Gingrich . 
erklaeren_s30289_f1	`` Oskarkeywordtag hat auf meine Frage hin 	erklärt 	, daß er ebenfalls kandidieren wird . '' 
erklaeren_s30384_f1	Für die endgültige Besetzung seien bereits `` mehrere Kandidaten in die engere Auswahl genommen '' , 	erklärt 	das Unternehmen . 
erklaeren_s30400_f1	Bereits im Sommer war von Verlusten die Rede , diekeywordtag zum Teil mit dem Engagement beim Maschinenbauer Schiess 	erklärt 	wurden . 
erklaeren_s30415_f1	Nach der generellen Öffnung des dortigen Marktes 1998 wolle das Quartett `` der führende Herausforderer von Telecom Italia werden '' , 	erklärt 	ein Sprecher von France Telecom . 
erklaeren_s30424_f1	`` France Telecom hat uns ein Angebot unterbreitet '' , 	erklärt 	ein Sprecher : 
erklaeren_s30607_f1	Gysikeywordtag 	erklärte 	im Saarländischen Rundfunk , er habe Lafontaine neulich in einer ZDF-Sendung getroffen und anschließend ein Gespräch mit dem mecklenburg-vorpommerschen SPD-Chef Ringstorff vereinbart : 
erklaeren_s30625_f2	Auch der Barrikadenbau am Eingang des ehemaligen Sprengel-Fabrikgeländes sei sokeywordtag zu erklären , meinte Albert . 
erklaeren_s30782_f1	Viele Wählerinnen und Wähler 	erklärten 	, sie seien zur Urne gegangen , damit der Friede im Lande zurückkehre . 
erklaeren_s30784_f1	`` Wir sind vor die Alternative gestellt worden , trotz der Morddrohungen zur Urne zu gehen oder die Lage anzunehmen , wie sie ist '' , 	erklärte 	ein Wähler in Tamanrasset . 
erklaeren_s30848_f1	Viele SPD-Stadtverordnete unterstützten Glaser nicht , weil erkeywordtag 	erklärt 	hatte , der Kampf für gewerbliche Arbeitsplätze in Frankfurt lohne nicht . 
erklaeren_s30925_f1	Der Präsident hatte zuvor im Fernsehen 	erklärt 	, er bleibe standfest auch wenn sich der Streit ein halbes Jahr lang hinziehen sollte . 
erklaeren_s30936_f1	`` Wilderer '' , 	erklärt 	Grzimeks Nachfolger Christian Schmidt . 
erklaeren_s30940_f1	Der Tierarzt des Berliner Zoos , Reinhard Göltenboth , 	erklärt 	, die Größe der zu überwachenden Gebiete und die Skrupellosigkeit der Banden hätten es den Wildhütern schwergemacht . 
erklaeren_s31006_f1	Der Vorsitzende Heinz-Werner Arens 	erklärte 	, es habe eine Vielzahl von Korrekturen an dem Berichtsentwurf gegeben , die aber nicht die Grundlinie verändert hätten . 
erklaeren_s31273_f1	`` Wenn die nigerianische Regierung nicht davor zurückschreckt , unmittelbar vor dem Commonwealth-Gipfel Ken Saro-Wiwa und acht weitere Menschen hinzurichten , müssen wir auch um das Leben der übrigen inhaftierten Ogoni fürchten '' , 	erklärte 	amnestykeywordtag . 
erklaeren_s31300_f1	Die Stadt wolle mit dem Vertrag die Schadstoffbelastung ihres regelmäßig ausgebaggerten Hafenschlamms langfristig verringern , damit nicht weiter ein Teil des Schlammes auf eine Sonderdeponie gebracht werden müsse , 	erklärte 	der VCI . 
erklaeren_s31410_f1	Dem Tribunal lägen Hinweise auf unvorstellbare Barbareien vor , 	erklärte 	Richter Fouad Riad . 
erklaeren_s31424_f1	Der Sprecher der Frankfurter Staatsanwaltschaft , Job Tilmann , hatte in der vergangenen Woche 	erklärt 	, bis zur Auslieferung Schneiders könnte möglicherweise noch ein weiteres Jahr vergehen . 
erklaeren_s31480_f1	Moskaukeywordtag hatte zuvor 	erklärt 	, es werde den Vertrag über die konventionelle Abrüstung in Europa nicht einhalten . 
erklaeren_s31570_f1	`` Wer uns besucht , '' so 	erklärt 	Walburga Staffler als Präsidentin des Fremdenverkehrsvereins , `` ist meist Gast in unseren eigenen Stuben . 
erklaeren_s31638_f1	Doch das gehörte der Vergangenheit an , als Pedro de Valdivia am 12. Februar 1541 am Fuße des Berges Huelén sein Schwert in den Boden rammte und die Stadt Santiago gründete , diekeywordtag erkeywordtag zur Hauptstadt des Königreiches Chile im spanischen Reich 	erklärte 	. 
erklaeren_s31672_f1	Seit die Stadt 1982 den Häuserblock zum Nationalen Monument 	erklärte 	, hat er sich in ein Künstlerviertel mit Studios , Kulturzentren und Restaurants verwandelt . 
erklaeren_s31823_f1	`` Zum Beispiel Rinderroulade , auf die sie drüben verzichten mußten , Steak oder ein typisches amerikanisches Gericht '' , 	erklärt 	Woelkikeywordtag . 
erklaeren_s31875_f1	Vielleicht können eines Tages mit seiner Hilfe auch andere gerichtete Bewegungen von Bakterien , wie etwa die Ausrichtung zur wärmeren oder auch zur sauerstoffhaltigeren Umgebung , 	erklärt 	werden . 
erklaeren_s32404_f1	Auch Fritz Pleitgen mochte in seiner Runde , zu der er sich immerhin fünf journalistische Expertinnen eingeladen hatte , partout nicht auf die Querelen um den Tagungsort verzichten , obwohl die Kolleginnen ihmkeywordtag mit engelshafter Geduld und vereinten Kräften immer wieder 	erklärten 	, daß die Entscheidung für diesen Ort 1992 fast ausschließlich von Männern gefällt worden war . 
erklaeren_s32719_f1	Dieskeywordtag 	erklärte 	der stellvertretende Premier und Minister für Tourismus , Frank Watson , auf dem 5. Weltkongreß `` Abenteuerreisen und Ökotourismus '' in Nassau . 
erklaeren_s32743_f1	Zum fünften Mal schon , so 	erklärt 	die Tonbandstimme , sei Mary Sullivan wegen Diebstahls von Glasteilen angeklagt - 
erklaeren_s33051_f1	In einer Stellungnahme vom Donnerstag 	erklärte 	das mexikanische Außenministerium zugleich , ai stelle tatsächliche Fälle übertrieben groß dar . 
erklaeren_s33138_f1	Daß sich das Trio nach ihren diversen Streitereien überhaupt noch einmal zusammengerauft hat , mag nicht mal der größte Beatles-Fan mehr mit dem Spaß an der Freud am gemeisamen Musizieren 	erklären 	. 
erklaeren_s33221_f1	Daß sich das Trio nach den diversen Zwistigkeiten überhaupt noch einmal zusammengerauft hat , mag nicht mal der größte Beatles-Anhänger mehr mit dem Spaß am gemeinsamen Musizieren 	erklären 	. 
erklaeren_s33250_f1	Nun müsse erkeywordtag 	erklären 	, wie diese Fehler aufgefangen werden könnten , verlangte Stolpe . 
erklaeren_s33716_f1	Der Bundestagsfraktion der SPD solle aber `` in dem Verfahren , wie es dann nachher im Bundestag ablaufen wird , freie Hand '' gelassen werden , 	erklärte 	der Parteichef . 
erklaeren_s33798_f1	Da nutzte erkeywordtag die Chance für eine kluge Intervention : 	erklärt 	und mahnt - nicht auf- aber eindringlich ; berichtet über die Situation in Rußland und warnt vor der Osterweiterung der Nato , rügt vorsichtig deren Einsatz in Bosnien . 
erklaeren_s33892_f3	Andere kritisierten , die Haltung der Kirche sei nur schwer zu erklären : 
erklaeren_s33958_f1	Im Dezember 1994 	erklärte 	der Essener EU-Gipfel den Kampf um mehr Jobs zur wichtigsten Aufgabe . 
erklaeren_s34166_f1	Abgelehnt wurde dagegen der Antrag des letzten SED-Generalsekretärs Egon Krenz , der - wie die anderen vier wegen der Toten an Mauer und Stacheldraht angeklagten SED-Politbüromitglieder - alle drei Richter für befangen 	erklärt 	sehen wollte , weil diese die Anklage im Eröffnungsbeschluß verschärft hatten . 
erklaeren_s34197_f1	Der Bundestagsfraktion der SPD solle aber `` in dem Verfahren , wie es dann nachher im Bundestag ablaufen wird , freie Hand '' gelassen werden , 	erklärte 	der Parteichef . 
erklaeren_s34273_f1	Ein `` Pressebüro gegen das Verbot der Demonstration vom 18. 11. 1995 '' 	erklärte 	am Samstag nachmittag , bei den Festnahmen sei es zu `` brutalen Mißhandlungen '' der Demonstranten gekommen . 
erklaeren_s34286_f1	In der vom Papst gebilligten Stellungnahme wird 	erklärt 	, das Verbot der Ordinierung von Frauen sei unwiderruflich und sollte daher überhaupt nicht erörtert werden . 
erklaeren_s34311_f1	Kurze Zeit später 	erklärte 	ein Anrufer bei westlichen Nachrichtenagenturen in Pakistan , die Gruppe Gamaa bekenne sich . 
erklaeren_s34436_f1	Admiral Richard Macke hatte 	erklärt 	, für den Preis des Mietautos hätten die Männer auch eine Prostituierte bezahlen können . 
erklaeren_s34438_f1	Japanische Frauenrechtsorganisationen 	erklärten 	, der Vergleich sei eine Banalisierung der Vergewaltigung und erniedrige alle Frauen . 
erklaeren_s34506_f1	Der Sprecher der Bundesanwaltschaft , Rolf Hannich , 	erklärte 	am Wochenende auf Anfrage , seine Behörde ermittle wegen des Verdachts der Agententätigkeit . 
erklaeren_s34543_f1	`` Gegen die Werksschließungen werden wir mit aller Macht angehen '' , 	erklärt 	Lüllmannkeywordtag . 
erklaeren_s34593_f1	`` So sind die Auszeichnungen wenigstens zu etwas nütze '' , 	erklärte 	der Vater von fünf Kindern , Miguel Angel Fernandez aus San Juan in Westargentinien . 
erklaeren_s34613_f1	Vielmehr 	erklärte 	erkeywordtag , daß er Platz für einen Kroaten machen müsse , um den Proporz in der Regierung der kroatisch- moslemischen Föderation herzustellen . 
erklaeren_s34642_f1	Allerdings wurden zwei Bestimmungen des neuen Wahlgesetzes für verfassungswidrig 	erklärt 	. 
erklaeren_s34663_f1	Die FIS hatte 	erklärt 	, es habe höchstens ein Drittel der Wähler abgestimmt . 
erklaeren_s34672_f1	Waskeywordtag wiederum 	erklären 	würde , warum sich seine Politik so schnell ändert . 
erklaeren_s34753_f1	Es gibt keine Klammer , die all dies zusammenhielte , keine Generaldiagnose , diekeywordtag den Fall `` 	erklärte 	'' und ordnete , die Lebenssplitter notdürftig verleimte . 
erklaeren_s34979_f1	Diese Kündigungen wurden am Mittwoch vom Bundesarbeitsgericht ( BAG ) für Rechtens 	erklärt 	, die beiden Kläger höchstrichterlich abgewiesen . 
erklaeren_s35638_f1	Auch der australische Regierungschef Paul Keating 	erklärte 	, sein Land werde die Einfuhrzölle auf 3000 Warengruppen ein Jahr früher als geplant reduzieren . 
erklaeren_s35646_f1	`` Wir haben alles erreicht , was wir wollten '' , 	erklärte 	Japans Außenminister Yohei Kono . 
erklaeren_s35762_f1	Bei seinem ersten öffentlichen Auftritt seit dem Scheitern seiner Kandidatur für den Posten des Nato-Generalsekretärs hat der frühere niederländische Premier Ruud Lubbers 	erklärt 	, er habe `` Verständnis '' für den Widerstand der USA gegen seine Kandidatur . 
erklaeren_s35806_f1	Das Gericht 	erklärte 	allerdings zwei Bestimmungen des neuen Wahlgesetzes für verfassungswidrig . 
erklaeren_s36065_f1	Nur aus des Japaners Biographie läßt sich das Werk 	erklären 	. 
erklaeren_s36295_f1	In der vom Papst gebilligten Stellungnahme wird 	erklärt 	, das Verbot der Frauen-Ordinierung sei endgültig und sollte daher nicht mehr erörtert werden . 
erklaeren_s36305_f1	Washingtonkeywordtag hatte zuvor 	erklärt 	, in den kommenden Monaten nicht an Verhandlungen über neue Mittel teilzunehmen . 
erklaeren_s36325_f1	`` Wer Haupt der tschetschenischen Republik werden will , soll seine Kandidatur 	erklären 	und sich auf gesamtgesellschaftlichen Wahlen stellen '' , forderte Moskaus neuer Statthalter in Grosny am Wochenende vor seinem Hausparlament . 
erklaeren_s36462_f1	Kurze Zeit später 	erklärte 	ein Anrufer bei westlichen Nachrichtenagenturen in Pakistan , die Gruppe Gamaa bekenne sich . 
erklaeren_s36672_f1	Den Vorstand und den Aufsichtsratsvorsitzenden habe Hofmann Ende Oktober über diesen Sachverhalt informiert , 	erklärt 	die Dresdner Bank jetzt . 
erklaeren_s36728_f1	Zuvor hatte die Gruppe 	erklärt 	, sie verhandle mit einem nicht genannten Interessenten . 
erklaeren_s36976_f2	Manager Verstynen bemühe sich die Mannschaft zu motivieren und ihr Mut zu machen , wird die Wende in Dortmund 	erklärt 	. 
erklaeren_s37456_f1	Dieskeywordtag 	erklärte 	Wirtschaftsminister Günter Rexrodt ( FDP ) bei der Eröffnung der Frankfurter Frühjahrsmesse Ambiente am Freitag abend . 
erklaeren_s37472_f1	`` Ich erwarte von einer unverwässerten Reform einen deutlichen Wachstumsschub '' , 	erklärte 	Rexrodtkeywordtag . 
erklaeren_s37562_f2	Vor allem in der zweiten Hälfte der Rechenperiode sei es deutlich aufwärts gegangen , 	erklärt 	das zur Privatisierung anstehende Unternehmen . 
erklaeren_s37722_f1	Auch Microsoft-Chef Bill Gates 	erklärt 	, daß dreidimensionale Grafiken bald den täglichen Umgang mit dem Rechner umkrempeln werden . 
erklaeren_s37905_f1	Dieskeywordtag 	erklärte 	der Leiter des IG-Metall-Bezirks Küste und letzte stellvertretende Vulkan-Aufsichtsratsvorsitzende , Frank Teichmüller , vor dem Untersuchungsausschuß in der Hansestadt . 
erklaeren_s37911_f1	Der Vorstand habe selber nicht 	erklären 	können , wie es 1995 zu dem `` schlimmen , fatalen Liquiditätsloch '' gekommen sei . 
erklaeren_s37943_f1	Die Telekom sei aufgefordert , sich `` möglichst umgehend für die Standardauskunft auf die vom 1. Januar 1998 an geltenden neuen Maßstäbe der Preisgestaltung umzustellen , wonach sich die Entgelte an den Kosten der effizienten Bereitstellung zu orientieren haben '' , 	erklärte 	das Ministerium . 
erklaeren_s37949_f1	Das Ministerium von Bötsch 	erklärte 	weiter , gegen die Verluste der Telekom-Komfortauskunft sei angesichts der andauernden Markteinführung derzeit nichts einzuwenden . 
erklaeren_s38024_f1	Bei den großen Messen gebe es Engpässe und einen Überhang bei den Anmeldungen , 	erklärte 	der Messechef . 
erklaeren_s38369_f1	Dieser sei `` auf ganzer Linie enttäuschend '' und verschlechtere nur die Lage Einkommenschwacher , 	erklärt 	Vesperkeywordtag . 
erklaeren_s38382_f1	Davon hätten etwa 90 Prozent den Vorschlag , der auch vom Betriebsrat befürwortet wurde , angenommen , 	erklärt 	die Unternehmensleitung . 
erklaeren_s38396_f1	Ein entsprechender Tarifvertrag zwischen dem Zentralverband der Deutschen Elektrohandwerke ( ZVEH ) und der IG Metall tritt rückwirkend zum 1. Juni in Kraft , nachdem die Bundesregierung nun die Vereinbarung für allgemeinverbindlich 	erklärt 	hat . 
erklaeren_s38581_f2	`` Die Franzosen sind mehr als alles andere Realpolitiker '' , 	erklärt 	Klaus Friedrich , Chefvolkswirt der Dresdner Bank , das Einlenken , `` sie wollen den Euro '' ebenso wie die Bundesregierung . 
erklaeren_s38723_f1	`` Notfalls '' würden die beiden Länder ihre Finanzverwaltung auch im Alleingang zu diesem frühen Zeitpunkt umstellen , 	erklärte 	der hessische Finanzminister Karl Starzacher ( SPD ) auf der Jahreskonferenz mit seinen Länderkollegen in Bad Homburg . 
erklaeren_s39211_f1	Dieskeywordtag 	erklärt 	die französische Regierung . 
erklaeren_s39732_f1	Eine Sprecherin des Instituts dagegen 	erklärt 	, daß die Wertpapierbörse eine Anfrage an das Institut gerichtet habe . 
erklaeren_s39805_f1	Nicht nur in der Gewerkschaftspolitik 	erklärte 	sich Labourkeywordtag mit den in langen Tory-Jahren geschaffenen Fakten einverstandenkeywordtag . 
erklaeren_s39842_f1	Die Mieten drohen aus Sicht des Grünen-Politikers mittelfristig drastisch zu steigen , 	erklärt 	erkeywordtag beim Königsteiner Gespräch des Instituts für Städtebau , Wohnungswirtschaft und Bausparwesen . 
