erlaeutern_s683_f2	Wiekeywordtag Verteidigungsminister Leo Delcroix in Brüssel 	erläuterte 	, wirdkeywordtag das jährliche Verteidigungsbudget in Höhe von 99 Milliarden Francs ( rund 4,8 Milliarden Mark ) bis 1997 eingefrorenkeywordtag . 
erlaeutern_s3073_f1	`` Der Westen hält die Summe hoch '' , 	erläutert 	Geschäftsführer Walter Seuferle , `` er gleicht den natürlichen Rückgang Ost aus . '' 
erlaeutern_s4330_f1	Ellemann-Jensen sagte , erkeywordtag sei bereit , auch anderen Nato-Mitgliedern seine Kandidatur zu erläutern . 
erlaeutern_s6801_f1	Mit einer solchen Vertrauenserklärung , die noch in dieser Woche von der Finanzministerkonferenz vereinbart werden soll , sollten sich die Steuerzahler darauf verlassen können , `` daß sie im nächsten Jahr nicht von einer Steuerveränderung zu ihrem Nachteil überrascht werden '' , 	erläuterte 	Waigelkeywordtag . 
erlaeutern_s6968_f1	`` Wildmuschelbänke dagegen haben eine positive Sauerstoffbilanz , weil die Artengemeinschaft mit Großalgen die Düngewirkung abpuffert '' , 	erläutert 	Biologe Asmus . 
erlaeutern_s10213_f1	Die Koalitionsvereinbarung wurde von Arbeitsminister Norbert Blüm ( CDU ) und Wirtschaftsminister Günter Rexrodt ( FDP ) 	erläutert 	. 
erlaeutern_s11803_f2	Draußen fällt ein kalter feuchter Schnee auf die Demonstranten vom Studentenrat , während Walther Benno Kießel vom Verband Alter Corpsstudenten 	erläutert 	, wie der korpsstudentische Gedanke neu entfacht werden muß . 
erlaeutern_s11897_f2	Beidekeywordtag sollten 	erläutern 	, `` wie sie sich die Erneuerung der europäisch-atlantischen Beziehungen vorstellen '' , was sie über die Aufgaben der Nato im bosnischen Kriegsgebiet denken und wie sie die Osterweiterung der Nato gestalten wollen . 
erlaeutern_s12472_f1	Der Krieg wurde in erster Linie gegen die Zivilbevölkerung geführt , 	erläuterte 	der Gesundheitsminister . 
erlaeutern_s14642_f1	Der langjährige Europa-Parlamentarier Professor Thomas von der Vring ( Bremen ) 	erläuterte 	: 
erlaeutern_s14762_f2	Siekeywordtag hört zu , 	erläutert 	Eurochinesischkeywordtag und `` klärt auf '' . 
erlaeutern_s15086_f1	Eskeywordtag handeltkeywordtag sichkeywordtag , wiekeywordtag ein US-Offizieller 	erläuterte 	, `` um Nato-Befehle ohne Nato-Briefkopf '' . 
erlaeutern_s15702_f1	Die knappen Frequenzen würden vorrangig Lizenznehmern zugeteilt , die bundesweit antreten , 	erläuterte 	Bötschkeywordtag . 
erlaeutern_s15797_f1	`` Damit haben wir nachgewiesen , daß die Pollendrift direkt von der Feldgröße abhängt '' , 	erläutert 	Wilkinsonkeywordtag . 
erlaeutern_s17097_f1	`` Der ISO-Start ist Höhepunkt von zwölf Jahren außerordentlicher Anstrengungen , das bislang leistungsfähigste und exakteste Infrarot-Teleskop in den Weltraum zu befördern '' , 	erläutert 	der Direktor des Wissenschaftsprogramms der Europäischen Weltraumorganisation ( ESA ) , Roger Bonnet . 
erlaeutern_s17259_f1	Dieses Gesetz sei kürzlich `` im Schnellverfahren '' reformiert worden , 	erläutert 	ai-Mitarbeiterin Barbara Neppert . 
erlaeutern_s21525_f2	Wiekeywordtag der Vorsitzende der französischen Gesellschaft für Kernenergie , Pierre Bacher , zum Abschluß einer Expertentagung 	erläuterte 	, sollkeywordtag der `` besonders sichere '' Reaktortyp den Energiebedarf der beiden Länder `` im kommenden Jahrhundert '' decken helfen . 
erlaeutern_s22592_f1	Sie wollen Werbung , keine Probleme '' , 	erläutert 	eine Vertreterin der Noworossijsk-Bank . 
erlaeutern_s23095_f1	Da hatte er auch im Hinterkopf , waskeywordtag erkeywordtag nicht öffentlich 	erläutern 	konnte , weil das wie eine Rechtfertigung Irans ausgesehen hätte : 
erlaeutern_s23205_f1	Wenn CDU-Generalsekretär Peter Hintze diesen Kurs öffentlich 	erläutert 	, klingt das so : 
erlaeutern_s23232_f2	Durch welche Länder er gereist sei und was die Fahrt gekostet habe , so 	erläuterte 	der Mann vor dem VGH , könnekeywordtag erkeywordtag nichtkeywordtag sagen . 
erlaeutern_s24311_f1	500 000 der 3,5 Millionen Einwohner Eritreas seien erreicht worden , 	erläutert 	Bereketkeywordtag . 
erlaeutern_s25513_f1	`` Niemand sollte vergessen , daß Vietnam eines der ärmsten Länder der Erde ist '' , 	erläutert 	der Vertreter einer deutschen Firma . 
erlaeutern_s26807_f2	`` Ich habe die Entscheidung aus einem Gefühl tiefer Menschlichkeit getroffen '' , 	erläuterte 	erkeywordtag seinen Schritt : 
erlaeutern_s27876_f1	`` Wie der lange Donnerstag gezeigt hat , führen längere Öffnungszeiten nicht zu mehr Umsatz , sondern zu Verlagerungen zur City und zur , grünen Wiese '' ' , 	erläutert 	Glaubitzkeywordtag . 
erlaeutern_s28600_f1	Der `` Trick '' dabei , wiekeywordtag Vogtkeywordtag 	erläutert 	: Die Verträge , die 1974 von Mohndruck und der IG Druck & Papier geschlossen wurden , hält die Geschäftsführung für gegenstandslos . 
erlaeutern_s31759_f2	Als kleiner Bub einst Meßdiener in der von 1744 bis 1765 errichteten Wallfahrtskirche , 	erläutert 	der stämmige Schwabe heute Schulklassen aus dem Saarland und Touristen aus Tokio die Bedeutung der Relique des heiligen Stephanus , die Einzelheiten der Rokoko-Beichtstühle oder der Totenkapelle . 
erlaeutern_s32130_f2	Für diese Argumentation kommt Penrosekeywordtag allerdings nicht umhin , einige grundlegende physikalische Theorien zu erläutern und zu benutzen , sowie sich einer mathematisch-logischen Struktur zu bedienen . 
erlaeutern_s33372_f1	`` Deutschland war das erste europäische Land , das den Mißbrauch von Kindern auch dann unter Strafe stellte , wenn er im Ausland geschah '' , 	erläutert 	Felizardokeywordtag . 
erlaeutern_s33682_f1	Soziologenkeywordtag verweisen bis ins 19. Jahrhundert zurück , um das Phänomen zu erläutern : 
erlaeutern_s35760_f2	Lubberskeywordtag 	erläutert 	Ablehnung durch USA 
erlaeutern_s37572_f1	`` Jetzt gibt es eine bessere Mitwirkung der Regierungen '' , 	erläutert 	Khazanah-Direktor Abdul Rshid Hussain , der damit offenbar eine mögliche Beteiligung des niederländischen Staates andeuten will . 
erlaeutern_s37847_f1	Man betreibe es , um die Kunden bei der Stange zu halten , 	erläutert 	Vorstandschef Anton Mauerer . 
erlaeutern_s38219_f1	Kritik äußern Arbeitnehmervertreter zudem daran , daß Dormannkeywordtag dem Volk nie selbst seine Radikalkur 	erläutert 	hat . 
erlaeutern_s38359_f1	Förderziel sei nicht mehr die Unterstützung breiter Schichten der Bevölkerung , sondern die bedürftiger Haushalte , 	erläutert 	Töpferkeywordtag . 
erlaeutern_s38769_f1	Die Stadt klagtkeywordtag nunkeywordtag , wiekeywordtag Oberbürgermeister Widder 	erläutert 	, für alle anderen Beteiligten auf dem Zivilrechtsweg auf Erfüllung des Vertrags durch die deutsche Tochter des französischen Konzerns Alcatel Alsthom . 
erlaeutern_s39517_f1	Die bisherigen Regelungen gelten weiterhin insbesondere in zwei Fällen , 	erläutert 	die Nürnberger Bundesanstalt für Arbeit : 
