finanzieren_s1765_f1	Nein , hohe Politik soll das sein , was sich derzeit um den Karenztag abspielt , mit dem die Pflegeversicherung 	finanziert 	werden soll . 
finanzieren_s3041_f1	Die beiden Parteien sind von der Regierung selbst gegründet und zu Beginn auch 	finanziert 	worden . 
finanzieren_s6790_f1	Die Entlastung soll Lafontaine zufolge durch ein behutsames Anheben der Steuern auf den Energieverbrauch 	finanziert 	werden . 
finanzieren_s8050_f1	Diese gesamtgesellschaftlichen Kosten müßten auch im Rahmen einer ökologischen Steuerreform 	finanziert 	werden , heißt es . 
finanzieren_s8654_f1	Das Jahrhundertvorhaben soll vor allem aus den Erlösen für Grundstücksverkäufe des freiwerdenden Gleiskörpers in Höhe von 2,175 Milliarden Mark 	finanziert 	werden . 
finanzieren_s8992_f1	Die SPD will die Senkung der Sozialbeiträge durch `` eine maßvolle , schrittweise Belastung des umweltschädlichen Energieverbrauchs '' 	finanzieren 	. 
finanzieren_s9121_f1	die Kosten für die Kontrolle müßten von den Behinderten 	finanziert 	werden , beklagen die Verbände . 
finanzieren_s11685_f1	- Das Bafög sollte dort eintreten , wo es den Eltern nicht möglich war , eine entsprechende Ausbildung zu finanzieren . 
finanzieren_s11698_f1	Weil Eltern ihren Beitrag nur bedingt steigern können , wird das studentische Budget mehr und mehr aus eigener Erwerbstätigkeit 	finanziert 	; 
finanzieren_s11717_f1	Geplant ist , die Lehrgangskosten und die Hälfte des Unterhaltsbetrages über verzinsliche Bankdarlehen zu finanzieren . 
finanzieren_s11965_f1	CDU und FDP forderten dagegen ein Privatisierungsprogramm , um aus dem so eingenommenen Geld `` Zukunftsinvestitionen '' ( etwa für Wissenschaft und Forschung ) zu finanzieren . 
finanzieren_s14152_f1	Noch wird der Gewinn nicht an die der Familie Oetker gehörende Mutter ausgeschenkt , sondern bleibt im Lande , um Investitionenkeywordtag zu finanzieren . 
finanzieren_s15959_f1	Moskaukeywordtag ist laut Gratschow bereit , das russische Kontingent der Truppe zu finanzieren . 
finanzieren_s19952_f1	Während die direkten pflegebedingten Kosten über die soziale Pflegeversicherung 	finanziert 	werden , müssen die darüber hinausgehenden Kosten , wie Unterkunft und Verpflegung bei stationärer Pflege , privat abgesichert werden . 
finanzieren_s20593_f1	Der offizielle Vorwurf lautet : Der KCTU werde vom kommunistischen Regime in Nordkorea 	finanziert 	. 
finanzieren_s20757_f1	Auf keinen Fall kann erkeywordtag mit ihnen die Mehrausgaben bei der Bundesanstalt für Arbeit 	finanzieren 	. 
finanzieren_s21091_f1	Der Bau wurde aber erst in den sechziger Jahren vorangetrieben und 	finanziert 	, als die beiden Nachbarstaaten im Rahmen eines Verteidigungspaktes noch als Verbündete auf der Seite des Westens standen . 
finanzieren_s21369_f1	Noch nie sei es für junge Leute so schwierig gewesen wie heute , ihr Studium zu finanzieren . 
finanzieren_s21869_f1	die szenische Uraufführung hat sich Leipzig gesichert , wenn eskeywordtag siekeywordtag denn im kommenden September 	finanzieren 	kann . 
finanzieren_s22030_f1	Der Kauf soll mit der teilweisen Ausnutzung des genehmigten Kapitals 	finanziert 	werden . 
finanzieren_s24825_f1	Die Unterhändler von 115 Ländern wollen auf der Konferenz in Jakarta festlegen , wiekeywordtag die Arbeit 	finanziert 	, der Technologietransfer in arme Länder geregelt und welche Schranken für die Gentechnik aufgebaut werden sollen . 
finanzieren_s25442_f1	Mit dem Geld werden Hilfsprojekte für Kinder in über 140 Ländern 	finanziert 	. 
finanzieren_s25549_f1	Ihr Kauf wurde mit 1,5 Millionen Mark aus der Kunststiftung des Oldenburger Industriellen Claus Hüppe 	finanziert 	. 
finanzieren_s26934_f1	Siekeywordtag nahmen die Vorfertigung am Standort Worms unter dem Namen MBW Maschinenbau in eigene Regie und 	finanzierten 	die Gründung mit Mitteln aus dem Sozialplan , die für ihre Abfindung vorgesehen waren . 
finanzieren_s28164_f1	Die Idee ist , daß nach dem Senior-Junior-Modell ein älterer Pastor nur noch zu 75 Prozent arbeitet und damitkeywordtag 25 Prozent des Gehalts eines jüngeren Kollegen an seiner Seite 	finanziert 	. 
finanzieren_s28185_f1	Dieserkeywordtag wiederum reicht nur knapp zur Hälfte aus , um das Gehalt des Juniors zu finanzieren . 
finanzieren_s28267_f1	Danach hätten Einzelhaushaltekeywordtag verabschiedet werden sollen , um bestimmte Teile der Exekutive bis zum 5. Dezember zu finanzieren . 
finanzieren_s30016_f1	Zu Clintons Glück versucht Gingrichkeywordtag sein Programm vor allem auf Kosten der sozial Schwachen , des unteren Mittelstands und der älteren Menschen zu finanzieren . 
finanzieren_s32986_f1	Die jetzigen Rentner müßten weiter vom Staat 	finanziert 	werden , und zum Teil auch diejenigen , die sich in den kommenden zehn bis zwanzig Jahren zur Ruhe setzen . 
finanzieren_s34250_f1	Der Haushalt der Europäischen Union steigt 1996 um acht Prozent auf rund 86 Milliarden Ecu ( etwa 160 Milliarden Mark ) , wovonkeywordtag 29 Prozent von Deutschland 	finanziert 	werden . 
finanzieren_s34770_f1	`` Wenn sich überhaupt einer beklagen könnte , dann ich '' , sagt er , der lange Klinken putzen mußte , um sein Projekt überhaupt 	finanziert 	zu bekommen , und dabei überall , zumal bei deutschen Verleihern , nur auf gelangweilte Gesichter stieß . 
finanzieren_s35011_f1	Es bedarf demokratischer Regulierung der Verteilung , um solche Arbeit zu finanzieren , die die Marktwirtschaft selbst nicht organisiert und leistet , da sie nicht unmittelbar rentabel und profitabel ist , die gesamtwirtschaftlich und gesamtgesellschaftlich dennoch höchst nützlich ist . 
finanzieren_s35013_f1	Im Gegenteil , die Produktivitätszuwächse , die gegenwärtig die Arbeitszeitvolumina der marktwirtschaftlichen Produktion von Waren und Dienstleistungen drastisch zurückgehen lassen , erlauben in verstärktem Maße Arbeitkeywordtag zu finanzieren und damit Arbeit zu leisten , von der nicht nur die gegenwärtige Lebensqualität , sondern auch die Zukunftsfähigkeit der Gesellschaften entscheidend abhängt . 
finanzieren_s36311_f1	Davon müßten aber nur etwa 13,6 Milliarden neu eingezahlt werden , der Rest werde aus Rückständen der laufenden IDA-10-Periode ( bisher nichteingezahlte Beiträge , darunter allein 934 Millionen Dollar der USA ) sowie aus Rückflüssen früherer Kredite 	finanziert 	. 
finanzieren_s38411_f1		Finanziert 	werden soll der Deal über Kredite und teilweise durch den Verkauf der Telefontochter Pacific Telecom für 1,5 Milliarden Dollar . 
finanzieren_s39243_f1	Mit dem erschwindelten Geld 	finanzierte 	das Trio nach Erkenntnissen der Richter weltweit einen aufwendigen Lebensstil . 
