fortsetzen_s731_f2	Die OECD empfahl daher , die Politik der Privatisierung und Geldwertstabilität 	fortzusetzen 	und das Wachstum des Staatsetats noch mehr zu begrenzen . 
fortsetzen_s1248_f1	Damit will das Unternehmen die Strategie 	fortsetzen 	, durch Rationalisierung und Verlagerung an kostengünstigere Produktionsstandorte in Europa wettbewerbsfähig zu bleiben . 
fortsetzen_s1323_f2	Reiche sagte , nach den Parlamentsferien Ende August könne die Beweisaufnahme 	fortgesetzt 	werden . 
fortsetzen_s1418_f1	Der designierte israelische Ministerpräsident Yitzhak Rabin hat am Montag seine Bemühungen mit dem Ziel 	fortgesetzt 	, eine Regierungskoalition unter der Führung seiner sozialdemokratischen Arbeitspartei zu bilden . 
fortsetzen_s1865_f2	Am Wochenende hat die JU diesen Kurs 	fortgesetzt 	, auf einem weiteren Landestag von der CDU einschneidende innerparteiliche Reformen verlangt und sich selbst in die massive Kritik einbezogen . 
fortsetzen_s1999_f3	Die Angriffe serbisch-montenegrinischer Verbände gegen Dubrovnik in Kroatien wurden auch am Sonntag 	fortgesetzt 	. 
fortsetzen_s2215_f1	Etwa 10 000 Soldaten mit 100 Panzern hätten die Angriffe gegen Dörfer im Bezirk Mardakert 	fortgesetzt 	. 
fortsetzen_s2993_f1	Kaske läßt keinen Zweifel daran , daß der faktische Belegschaftsabbau 	fortgesetzt 	werden wird . 
fortsetzen_s3135_f1	Luftbrücke für Sarajewo trotz Kämpfen 	fortgesetzt 	
fortsetzen_s3366_f1	Ob die Regierung die gewaltsamen Räumungen 	fortsetzen 	würde , war zunächst nicht klar . 
fortsetzen_s3530_f2	Dieserkeywordtag 	setzte 	am Montag abend die Suche nach einem im Bundestag und Bundesrat mehrheitsfähigen Kompromiß fort ; 
fortsetzen_s4091_f2	Der 46jährige , der im Kabinett bislang für die Beziehungen zu internationalen Finanzorganisationen zuständig war , kündigte an , die Wirtschaftsreformen 	fortzusetzen 	. 
fortsetzen_s4502_f2	Die New Yorker Aktienbörse hat am Freitag ihre Rekordfahrt 	fortgesetzt 	. 
fortsetzen_s4590_f3	In den Schock über den Verlust des `` Architekten '' des Nahost-Friedensprozesses mischte sich die Hoffnung , daß die Aussöhnung zwischen Israelis und Arabern auch ohne den Staatsmann und Friedensnobelpreisträger 	fortgesetzt 	werden könne . 
fortsetzen_s4651_f1	Die israelische Regierung will auch nach der Ermordung von Ministerpräsident Yitzhak Rabin dessen Friedenspolitik 	fortsetzen 	. 
fortsetzen_s5892_f2	Diplomatische Beobachter glauben , daß der Ägypter im Auftrag seines syrischen Freundes und Bundesgenossen Hafis el Assad sondieren wird , unter welchen Bedingungen die derzeit ruhenden Verhandlungen zwischen Jerusalem und Damaskus 	fortgesetzt 	werden können . 
fortsetzen_s6303_f2	Damit habe sich der Trend des ersten Halbjahres 	fortgesetzt 	. 
fortsetzen_s6930_f1	Die FR-Serie `` Greenpeace , was nun ? '' wird 	fortgesetzt 	. 
fortsetzen_s7396_f1	CDU und PDS setzten gemeinsam durch , daß in der neugegründeten Akademie der Künste Berlin-Brandenburg die ehemaligen Honecker-Berater in Sachen Kunst ihre Arbeit nun als Berater von Stolpe und Diepgen 	fortsetzen 	konnten . 
fortsetzen_s7405_f2	Hatten sie sich doch darauf verlassen , daß die Berliner CDU ihr Verhalten von 1992 - Zählgemeinschaften gegen die PDS zu fordern - 	fortsetzen 	würde . 
fortsetzen_s7514_f1	Aber diese dringende Aufgabe ist zu lösen , ganz gleich , ob wirkeywordtag die große Koalition 	fortsetzen 	oder in die Opposition gehen . 
fortsetzen_s7577_f2	Das zu Recht beklagte Auseinanderdriften von Partei und Fraktion würde sich 	fortsetzen 	, wir würden auch künftig kein geschlossenes Erscheinungsbild abgeben und nicht mit gemeinsamen Überzeugungen draußen wieder Terrain zurückgewinnen können . 
fortsetzen_s8374_f2	Das beste Denkmal für den Toten ist , sein Werk des Friedens 	fortzusetzen 	. '' 
fortsetzen_s8498_f2	Den Tod des israelischen Ministerpräsidenten Yitzhak Rabin durch ein Attentat haben Staatsgäste aus aller Welt bei der Trauerfeier am Montag in Jerusalem als Verpflichtung bewertet , den Friedensprozeß im Nahen Osten 	fortzusetzen 	. 
fortsetzen_s8790_f2	Nach den Worten seines amtierenden Regierungschefs Shimon Peres will Israelkeywordtag den Abzug seiner Besatzungstruppen aus dem Westjordanland auch am heutigen Dienstag 	fortsetzen 	. 
fortsetzen_s9670_f1	Doch Umweltmanager Mick Petermann scheiterte mit seinen Vorstellungen , mußte gehen , letztlich deshalb , weil zwischen ihm und dem für die Fachthemen zuständigen Geschäftsführer Onno Poppinga erbitterte Gegnerschaft entstanden war , diekeywordtag sich in den Vorstand 	fortsetzte 	und dort weder inhaltlich noch personell aufgefangen wurde . 
fortsetzen_s9925_f1	Die israelische Armee wird ihren Rückzug aus dem Westjordanland 	fortsetzen 	. 
fortsetzen_s9937_f2	Die nach dem Attentat einstweilen unterbrochenen Gespräche zwischen Israel und den Palästinensern über Details des Abzugs aus Dschenin im Westjordanland sollen ebenfalls 	fortgesetzt 	werden . 
fortsetzen_s12489_f3	Bei regionalen und kommunalen Wahlen in den USA sind am Mittwoch die Hoffnungen der Republikanischen Partei enttäuscht worden , ihrenkeywordtag im November 1994 bei den nationalen Wahlen begonnenen Siegeszug gegen die Demokraten von Präsident Bill Clinton 	fortsetzen 	zu können . 
fortsetzen_s12519_f2	Das US-Repräsentantenhaus sprach sich am Dienstag abend dafür aus , die Finanzhilfe für die Palästinenser 	fortzusetzen 	. 
fortsetzen_s13754_f2	Die hiesigen Börsen haben ihre Aufwärtsbewegung gestern 	fortgesetzt 	. 
fortsetzen_s15783_f1	Dieser Weg müsse konsequent 	fortgesetzt 	werden , aber `` ohne das Auto zu verteufeln '' . 
fortsetzen_s16252_f1	Der Prozeß wird am Mittwoch 	fortgesetzt 	. 
fortsetzen_s16357_f1	Die Armee hatte am Morgen ihren Vormarsch auf die Stadt Jaffna auf der gleichnamigen Halbinsel 	fortgesetzt 	. 
fortsetzen_s19593_f3	Bei den VW-Tarifverhandlungen im Oktober wurde vereinbart , die im Januar 1994 eingeführte Vier-Tage-Woche mit einer Arbeitszeit von 28,8 Stunden 	fortzusetzen 	. 
fortsetzen_s21634_f2	Der Wirtschaftsaufschwung in Deutschland wird sich nach Einschätzung der sogenannten `` fünf Wirtschaftsweisen '' 1996 nur schleppend 	fortsetzen 	. 
fortsetzen_s21916_f1	Die FR-Worldwatch-Serie wird 	fortgesetzt 	. 
fortsetzen_s22856_f1	Bis zum Abzug würden derartige Anschläge 	fortgesetzt 	. 
fortsetzen_s24778_f1	Die Piloten der spanischen Fluggesellschaft Iberia haben am Dienstag ihren Streik gegen Pläne zur Sanierung des Unternehmens 	fortgesetzt 	. 
fortsetzen_s25926_f1	Protestekeywordtag 	fortgesetzt 	
fortsetzen_s25961_f2	Mit seinenkeywordtag Versprechen , den wirtschaftsliberalen Kurs von de Leon Carpio 	fortzusetzen 	, kann er auf die Unterstützung der Unternehmer rechnen . 
fortsetzen_s26374_f1	siekeywordtag wird dieskeywordtag mit wissenschaftsadäquaten Vorschlägen 	fortsetzen 	. 
fortsetzen_s27373_f1	Wellek , damals Professor an der Yale University , vermochte den New Criticism im deutschen akademischen Betrieb zwar nie als eigenen Zweig zu etablieren , aber sein mit zusammen Austin Warren verfaßtes Werk erreichte große Verbreitung gerade unter jenen Studenten , diekeywordtag mit einer `` deutschen Literaturwissenschaft '' zu brechen entschlossen waren und die historistische Tradition auch nicht unter neomarxistischen Vorzeichen 	fortzusetzen 	gewillt waren . 
fortsetzen_s27834_f2	Shellkeywordtag ist entschlossen , sein fast 50jähriges Engagement in dem Land nicht nur in vollem Umfang 	fortzusetzen 	, sondern es mit dem Bau einer Naturgas-Fabrik , der größten industriellen Investition in Schwarzafrika , noch auszubauen . 
fortsetzen_s29211_f1	Natürlich wird sich dieser Weg so nicht 	fortsetzen 	lassen : 
fortsetzen_s30825_f2	Sein Land bekomme durch die Vereinbarung mit den privaten Geldgebern eine Atempause , um die wirtschaftlichen Reformen erfolgreich 	fortsetzen 	zu können . 
fortsetzen_s31137_f1	Obwohl auch China seine Atomtests 	fortgesetzt 	hat , richtete sich die Resolution vor allem gegen Frankreich , dessen Staatspräsident Jaques Chirac ungeachtet internationaler Proteste auf der Fortsetzung der nuklearen Testserie beharrt . 
fortsetzen_s31282_f2	Bei seinem Besuch in Hanoi hat Bundeskanzler Helmut Kohl Vietnam am Freitag dazu aufgerufen , die eingeleiteten Wirtschaftsreformen 	fortzusetzen 	. 
fortsetzen_s36283_f2	Weisner teilte mit , in wenigen Tagen werde die Aktion in Südtirol und im kommenden Jahr in Flandern 	fortgesetzt 	. 
fortsetzen_s36497_f2	`` Daher sind die Aussichten gut , daß sich der seit dem Frühjahr vergangenen Jahres andauernde Wachstumsprozeß 	fortsetzt 	. '' 
fortsetzen_s36654_f2	Nach Einschätzung der Konjunkturforscher wird das Wachstum in den 29 Mitgliedsländern im zu Ende gehenden Jahr vermutlich drei Prozent betragen : In der kommenden Periode dürfte eskeywordtag sich in diesem Tempo 	fortsetzen 	, bevor es 1999 auf rund zweieinhalb Prozent zurückgehe . 
fortsetzen_s37491_f3	Vor kurzem verbot der Agiv-Vorstand dem Kaufinteressenten , die Prüfung der angeschlossenen Firmen 	fortzusetzen 	. 
