gefaehrden_s722_f1	Er führt dies auf die politischen Schwierigkeiten in dem Land hin , diekeywordtag die Wirtschaftsreformen 	gefährden 	könnten . 
gefaehrden_s1277_f1	Millionenverlustekeywordtag 	gefährden 	den zweitgrößten dänischen Versicherer , die Hafnia-Gruppe . 
gefaehrden_s1625_f1	Um seine Vermittlungsbemühungen nicht zu gefährden , verpflichtete Butros Ghali seine Gesprächspartner zu strengstem Stillschweigen . 
gefaehrden_s1843_f1	Die Zukunft der aus ABM-Töpfen finanzierten Sanierungsgesellschaft , bei der viele Mifa-Arbeitnehmer untergekommen sind , ist 	gefährdet 	. 
gefaehrden_s2339_f1	Seine Regierung 	gefährde 	den sozialen Ausgleich . 
gefaehrden_s2801_f1	Die Bundesregierung 	gefährdet 	nach Auffassung des Präsidenten der Kultusministerkonferenz der Länder ( KMK ) , Diether Breitenbach ( SPD ) , mit `` falscher Sparpolitik '' den weiteren Ausbau der mit 1,8 Millionen Studenten überfüllten Hochschulen . 
gefaehrden_s2804_f1	Durch das Veto von Finanzminister Theo Waigel ( CSU ) seien viele Aus- und Neubauprojekte von Hochschulen in allen Bundesländern 	gefährdet 	, meinte Breitenbach , der Wissenschaftsminister im Saarland ist . 
gefaehrden_s4186_f1	Die HBV verwies am Sonntag in Düsseldorf auf ein Gutachten des Institutes für Medienforschung und Urbanistik , wonach eine Ausweitung der Öffnungszeiten im Einzelhandel eher Arbeitsplätzekeywordtag 	gefährde 	als welche schaffe . 
gefaehrden_s4586_f1	`` Rabinkeywordtag 	gefährdet 	das Leben der Juden , schafft einen Terrorstaat und ergreift harte Maßnahmen , so daß er nicht überrascht sein darf , wenn auch gegen ihn harte Maßnahmen unternommen werden . '' 
gefaehrden_s5142_f1	Es wäre besonders fatal , wenn durch das dumme Gerede über die scheinbar schlechte Qualität des Standortes Deutschland noch weitere Arbeitsplätze 	gefährdet 	würden . 
gefaehrden_s6283_f1	Etliche Studien in Europa und den USA dokumentieren , daß Menschen mit Kopien von apo E-4 insgesamt stärker 	gefährdet 	sind und sogar bei Unfällen schlechtere Überlebenschancen haben . 
gefaehrden_s6285_f1	Er errechnete , daß jene mit apo E-4 dreimal so stark 	gefährdet 	waren , an der Hirnblutung zu sterben , wie die Träger anderer apo E-Versionen . 
gefaehrden_s6288_f1	Danach sind Frauen mittleren Alters mit apo E-4 doppelt so stark 	gefährdet 	, am Herz zu erkranken , wie Gleichaltrige mit einer anderen apo E-Version . 
gefaehrden_s6823_f1	Zudem verweisen sie darauf , daß die genannten 13 Tierarten in Kanada nicht 	gefährdet 	seien . 
gefaehrden_s7573_f1	Eine solche Regierungsform gehört in vielen , oft sehr viel älteren Demokratien z. B. in Skandinavien und den Benelux-Staaten zur alltäglichen Normalität , ohne daß diese Staaten als Wirtschaftsstandort 	gefährdet 	werden . 
gefaehrden_s7642_f1	Amir sagte , er habe Rabin aus so kurzer Entfernung erschossen , weil erkeywordtag Umstehendekeywordtag nicht habe 	gefährden 	wollen . 
gefaehrden_s8624_f1	Frauen in Peru 	gefährdet 	
gefaehrden_s9099_f1	Der Sprecher sagte auch , daß die Giftwolke die Anwohner um die Fabrik nicht 	gefährdet 	habe . 
gefaehrden_s9117_f1	Die Verbände kritisierten , nach dem vorliegenden Gesetzentwurf sei die Existenz von zahlreichen Einrichtungen für geistig Behinderte 	gefährdet 	, die von pädagogischen Fachkräften geleitet würden . 
gefaehrden_s10353_f1	Lockerungen im Umgang damit 	gefährdeten 	den `` Standort Deutschland '' . 
gefaehrden_s14906_f1	Ohne politische Rahmensetzung 	gefährdet 	der weltweite Freihandel die soziale Demokratie und den sozialen Zusammenhalt , ohne die auf Dauer keine offene Gesellschaft stabil sein kann . 
gefaehrden_s15950_f1	Andernfalls drohe der Kostenschub sogar weitere Arbeitsplätze zu gefährden . 
gefaehrden_s16096_f1	Die `` Handlungsblockade '' in der Koalition 	gefährde 	die Zukunft der GKV als einem Eckpfeiler des Sozialstaates . 
gefaehrden_s16179_f1	Wie Polizei und Staatsanwaltschaft am Freitag in Dresden mitteilten , wollte der am Vortag verhaftete Vorstandsvorsitzende der Kreissparkasse Hainichen sich mit der Entführung des Landrats offenbar dafür rächen , daß dieserkeywordtag die Fusion seiner Bank mit der Kreissparkasse Rochlitz vorangetrieben und damitkeywordtag seinen Posten 	gefährdet 	hatte . 
gefaehrden_s17421_f1	Auch Hotels , die während Rundreisen benutzt werden , gelten als `` nicht 	gefährdet 	'' . 
gefaehrden_s17542_f1	Auch Hotels , die während Rundreisen benutzt werden , gelten als `` nicht 	gefährdet 	'' . 
gefaehrden_s18072_f1	Ohne politische Rahmensetzung 	gefährdet 	der weltweite Freihandel die soziale Demokratie und den sozialen Zusammenhalt , ohne die auf Dauer keine offene Gesellschaft stabil sein kann . 
gefaehrden_s18216_f1	Alex Möller trat vorzeitig zurück , weil erkeywordtag durch die ungezügelten Erwartungen der Regierungspartei die Preisstabilität 	gefährdet 	sah . 
gefaehrden_s19103_f1	Nach Ansicht des Ministers wird dadurchkeywordtag der `` innere Frieden in Deutschland 	gefährdet 	'' . 
gefaehrden_s19913_f1	Dieserkeywordtag darf durch Nachlässigkeit der Arbeitgeber nicht 	gefährdet 	werden . 
gefaehrden_s20545_f1	Zu sehr , heißt es , hänge westlicher Wohlstand an nigerianischem Öl , zu groß seien die Exportüberschüsse , als daß Staaten wie Großbritannien siekeywordtag ernsthaft 	gefährden 	würden . 
gefaehrden_s20706_f1	Die Opfer hätten sichkeywordtag bewußt selbst 	gefährdet 	. 
gefaehrden_s20962_f1	Dieskeywordtag 	gefährde 	den im Grundgesetz garantierten Rechtsschutz der Bürger gegen die öffentliche Verwaltung , warnte die Vereinigung der Verwaltungsrichter und Verwaltungsrichterinnen des bevölkerungsreichsten Bundeslandes am Montag in Köln . 
gefaehrden_s21395_f1	Außenminister Klaus Kinkel ( FDP ) nannte bei einem Auftritt vor der Rektorenkonferenz den Studienstandort Deutschland 	gefährdet 	. 
gefaehrden_s24113_f1	Die Informations- und Kommunikationstechnologie 	gefährdet 	auf der anderen Seite BürgerInnenrechtekeywordtag in hohem Maße . 
gefaehrden_s24138_f1	Wenn sichkeywordtag das politische System nicht selbst 	gefährden 	, gar überflüssig machen will , liegt hierin dringender Handlungsbedarf . 
gefaehrden_s24585_f1	Zwar werde das nur mäßige Expansionstempo in Westdeutschland auch im Osten zu spüren sein , doch würden dort allenfalls Investitionspläne gestreckt oder etwas korrigiert , aber den Aufbauprozeß nicht 	gefährden 	. 
gefaehrden_s24814_f1	Laut dem ersten globalen Report , in dem die biologische Vielfalt bewertet wird , sind mindestens 5400 Tier- und 26 100 Pflanzenarten 	gefährdet 	. 
gefaehrden_s26372_f1	3. Die trotz der anerkennenswerten Leistungen des Landes weiterbestehende jahrelange Unterfinanzierung der Universität bedroht die Ausbildungsqualität und damit die Zukunft der in der Ausbildung stehenden Generation , siekeywordtag 	gefährdet 	die Wettbewerbsfähigkeit der Forschung , einen wesentlichen Faktor der Entwicklung unseres Landes . 
gefaehrden_s27531_f1	Aber Rabattflutkeywordtag 	gefährdet 	Sanierungserfolgekeywordtag / 
gefaehrden_s27537_f1	Ein `` kopfloser '' Wettlauf um Marktanteile mit immer neuen Nachlässen 	gefährde 	zudem die Sanierungserfolge der Karossen-Assekuranzen , warnt Michaels . 
gefaehrden_s27976_f1	Der WWF setzt sich für eine Nutzung der Arten ein , diekeywordtag deren Bestand nicht 	gefährdet 	, und unterstützt Forscher bei der Suche nach Ersatzstoffen . 
gefaehrden_s28195_f1	Schwankend zwischen `` Ruptura '' , dem radikalen Bruch mit der Franco-Ära , und `` Reforma '' nahm ein Reformprozeß seinen Lauf , denkeywordtag um ihre Privilegien kämpfende Franco-Anhänger immer wieder 	gefährdeten 	. 
gefaehrden_s29692_f1	Denn ihrer Auffassung nach würden erneute Belastungen `` nicht zuletzt die noch zögerliche Belebung der Investitionsbereitschaft aufs Spiel setzen und damitkeywordtag eine wesentliche Voraussetzung für einen länger anhaltenden selbsttragenden Aufschwung 	gefährden 	'' . 
gefaehrden_s30011_f1	Daß erkeywordtag damitkeywordtag die Verhandlungen 	gefährdete 	, störte Clinton nicht . 
gefaehrden_s30937_f1	Das Washingtoner Artenschutzabkommen listet das Rhinozeros als stark 	gefährdet 	auf . 
gefaehrden_s38580_f1	`` Wir werden es tun , glaube ich '' , tat der sozialistische Premier Lionel Jospin kund , nachdem man noch zu Beginn der Woche befürchten mußte , das Projekt könnte während der von Frankreich erbetenen `` Bedenkzeit '' auf die ganz lange Bank geschoben werden , waskeywordtag im äußersten Fall den termingerechten Beginn der Währungsunion wie auch die Verabschiedung der politischen und institutionellen EU-Reformen ( `` Maastricht II '' ) 	gefährdet 	hätte . 
gefaehrden_s39830_f1	Die Gewerkschaften indes , diekeywordtag sich im Wahlkampf äußerst still verhalten haben , um bloß den Labour-Erfolg nicht zu gefährden , können ihre Skepsis kaum noch verbergen , angesichts der `` lauen Politik '' , die Blair und Brown sich zu eigen gemacht haben . 
