informieren_s1446_f1	Er erinnerte daran , daß auch Jelzin sehr gut `` über die Aktivitäten der KPdSU '' 	informiert 	gewesen sei . 
informieren_s2259_f1	Am Montag 	informierte 	ihnkeywordtag der Vertreter der Solidarität-Fraktion , Jan Rulewski , über die Initiative der Parteien , die aus der Solidarität hervorgegangen sind , hinter der Kandidatur von Frau Suchocka stehen und sich zu einer Koalition zusammengeschlossen haben . 
informieren_s2399_f1	Waffenschmidtkeywordtag will sich in den nächsten Tagen im Altai-Gebiet , an der Wolga und in der Südukraine über die Ansiedlung der Rußlanddeutschen 	informieren 	. 
informieren_s5411_f1	Was außer einer guten Examensnote für den Berufsweg , soll er denn in Topetagen hinaufführen , alles nötig ist , darüber 	informiert 	das Handbuch `` Berufsplanung für den Management-Nachwuchs '' . 
informieren_s5413_f1	Der Band behandelt die Themen Studien- und Examensplanung , Aus- und Weiterbildung , Bewerbung und Vorstellung , 	informiert 	über Anfangsgehälter und gibt Versicherungstips . 
informieren_s8316_f1	Insgesamt 20 Geschosse will er für Yigal Amir gefertigt haben , über dessen Absichten erkeywordtag nach eigenen Angaben aber nicht 	informiert 	gewesen sei . 
informieren_s8382_f1	US-Präsident William Jefferson Clinton , der wie so viele die tiefe , rauhe Stimme Rabins vermißte , schien gut 	informiert 	über die Lage in Israel . 
informieren_s9165_f1	Die Dokumente würden darlegen , daß die Regierung über die Exporte in den 80er Jahren 	informiert 	gewesen sei und nur so getan habe , als wisse sie von nichts . 
informieren_s9686_f1	Einziger Unterschied : Der NABU wirbt Mitglieder , der BUND nur Förderer , diekeywordtag aber ebenfalls ständig über die Arbeit der Ortsgruppe 	informiert 	werden und natürlich das Verbandsorgan im Briefkasten finden . 
informieren_s9793_f1	Der Aufsichtsrat wird über Managementveränderungen nur 	informiert 	; 
informieren_s11128_f1	Die Bundestagsfraktion von Bündnis 90 / Die Grünen forderte die Bundesregierung auf , das Parlament über `` die aktive Beteiligung des Bundeskriminalamts an Einfuhr und Vertrieb großer Mengen Drogen '' nach Europa zu informieren . 
informieren_s12090_f1	Deutsche Bank 	informiert 	/ 
informieren_s13139_f1	Insgesamt kaufe der Kunde selten spontan , sondern 	informiere 	sich meist vorher über das Angebot . 
informieren_s14252_f1	Ganz nach Vorschrift habe Londonkeywordtag im Februar die anderen Zeichnerstaaten der einschlägigen Oslo-Paris-Konvention über den Versenkungsplan 	informiert 	. 
informieren_s15998_f1	Der ehemalige Kommandeur der UN-Truppen in Ruanda hat eigenen Angaben zufolge die Vereinten Nationen ( UN ) bereits im Januar 1994 über die Vorbereitungen der großangelegten Massaker in dem afrikanischen Staat 	informiert 	. 
informieren_s17142_f1	Die Aufnahmen geben einen guten und spannend dargestellten Überblick über die einzelnen Entwicklungsstadien und 	informieren 	zugleich auch über die Methoden der ärztlichen Überwachung , den Ultraschall zum Beispiel , und die kritischen Phasen der Schwangerschaft . 
informieren_s20486_f1	Am vergangenen Dienstag erhielt er per Fax die Nachricht , Lehmann sei bereit , sich persönlich von den Initiatoren das Ergebnis mitteilen zu lassen , vorausgesetzt daß die Medien nicht vorher 	informiert 	würden . 
informieren_s21159_f1	Wirkeywordtag 	informieren 	dann die Arbeitgeber - die ja immer sagen , daß sie gegen Lohndumping sind . '' 
informieren_s21625_f1	Charles , der großes Interesse für Architektur hat , ließ sich in dem Neubauviertel über die Sanierung von DDR-Plattenbauten 	informieren 	. 
informieren_s22531_f1	Über diese sollten sich die Beschäftigten selbst , vor allem aber die Arbeitgeber und die Betriebs- beziehungsweise Personalräte 	informieren 	. 
informieren_s22670_f1	Über die neuesten Trends der Branche 	informiert 	noch bis heute die Dima-Messe in Wiesbaden . 
informieren_s22674_f1	`` Die klassischen Agenturen 	informieren 	sich nicht mal '' , ärgert sich Herbst . 
informieren_s22906_f1	Die Düsseldorfer Parlamentarier von SPD , Bündnis 90 / Die Grünen und CDU sowie von den Parteien eingeladene Experten hatten sich in den Ostprovinzen der Türkei über die Lage der Kurden 	informieren 	wollen . 
informieren_s22909_f1	In der vergangenen Woche 	informierte 	das türkische Außenministerium den deutschen Botschafter in Ankara , daß die Delegation in der Türkei nicht willkommen sei . 
informieren_s23360_f1	Meyer hatte beklagt , daß Peymannkeywordtag es versäumt habe , die Darsteller über Premierenverschiebungen zu informieren oder über die Besetzung von Rollen durch Gäste Auskunft zu geben : 
informieren_s23863_f1	Auch BASF interessierte sich für diese Aktivitäten , wurde aber gestern von Monsanto darüber 	informiert 	, daß sie aus dem Rennen ist . 
informieren_s24708_f1	Seit langem bemerke ich mit Entsetzen in den israelischen Medien die Tendenz , über Ankündigungen und Aktivitäten der rechten Opposition und vor allem der rassistischen Siedler in den palästinensischen Gebieten zu informieren , wohingegen Aktivitäten für Frieden und Versöhnung ausgeblendet oder nur sporadisch gemeldet wurden . 
informieren_s24796_f1	Parlamentarier aus Nordrhein-Westfalen , diekeywordtag sich über sogenannte `` innerstaatliche Fluchtalternativen '' für Kurden aus den Ostprovinzen der Türkei 	informieren 	wollen , sind nach Darstellung des türkischen Generalkonsuls Ömer Altug `` immer herzlich willkommen '' - allerdings unter der Bedingung , daß die türkische Regierung bestimmen kann , wer dieser deutschen Delegation angehört . 
informieren_s25076_f1	Nein , hier in der 196. Infanteriedivision , so wird der deutsche Bundeskanzler 	informiert 	, beschäftigen sich die Soldaten mit Fischteichen und eigenen Fabriken . 
informieren_s26417_f1	Rektor Svec sei `` offenbar über die dubiosen Tätigkeiten der , Gesellschaft für Wissenschaft und Lehre ' nicht 	informiert 	'' , beantwortete aber die Frage , ob sich Bewerber auch direkt an die Universität wenden können , nur `` ausweichend '' . 
informieren_s31008_f1	Festgestellt wurde zudem , daß Björn Engholm bereits im Frühsommer 1987 von den Machenschaften 	informiert 	gewesen sei . 
informieren_s31009_f1	Engholm selbst hatte im Mai 1993 eingeräumt , eine Woche vor der Landtagswahl im September 1987 	informiert 	worden zu sein . 
informieren_s31982_f1	Der Katalog 	informiert 	ausführlich über Länge und Schwierigkeitsgrad der Langlaufloipen und Alpinabfahrten . 
informieren_s33099_f1	Die PR-Spezialisten der EMI haben die Medien schon vor einer Woche über den `` streng geheimen '' Transport 	informiert 	. 
informieren_s33180_f1	Die PR-Spezialisten der EMI 	informierten 	die Medien schon vor einer Woche über den `` streng geheimen '' Transport . 
informieren_s33603_f1	Nach Angaben der Polizei waren am 9. November um 1.03 Uhr zeitgleich Polizei und Feuerwehr über das Feuer 	informiert 	worden . 
informieren_s34980_f1	Sie hatten die Entlassungen im wesentlichen mit der Begründung angefochten , daß der Betriebsrat nicht ordnungsgemäß 	informiert 	worden und das Anhörungsverfahren auch nicht korrekt gewesen sei . 
informieren_s35512_f1	Eigentlich hatte sich der Rechtsausschuß des Bundestages in einer für kommende Woche geplanten Anhörung nur noch darüber 	informieren 	wollen , wie die wenigen überlebenden Opfer der nationalsozialistischen Militärjustiz rehabilitiert und entschädigt werden können . 
informieren_s35842_f1	Der Exporteur von modifizierten Organismen werde durch das Protokoll künftig das Einverständnis des Importlandes einholen und über Risiken 	informieren 	müssen . 
informieren_s36672_f1	Den Vorstand und den Aufsichtsratsvorsitzenden habe Hofmannkeywordtag Ende Oktober über diesen Sachverhalt 	informiert 	, erklärt die Dresdner Bank jetzt . 
informieren_s37627_f1	Für Robert Rockwell , Chief Scientist von Black Sun Interactive , geht es um `` ein weltweites Geflecht virtueller Szenen , in denen Menschenkeywordtag sich treffen können : sich unterhalten , sich 	informieren 	, ihre geschäftlichen sowie ihre persönlichen Beziehungen pflegen '' . 
informieren_s39551_f1	Die Gäste der Bank-Bistros können sich zum Beispiel per Internet über aktuelle Börsenkurse 	informieren 	, am PC Wirtschaftsnachrichten lesen oder sich , gemeinsam mit einem Berater vor dem Terminal sitzend , rechnergestützt Finanzierungs- und Anlagepläne erstellen lassen . 
informieren_s39879_f1	Eskeywordtag 	informiert 	über die Besitzstrukturen von 13 000 Firmen mit einem Nominalkapital ab einer Million Mark . 
