interpretieren_s4430_f1	Am Samstag betonte Tschernomyrdin , seine Äußerungen seien `` falsch 	interpretiert 	'' worden . 
interpretieren_s5865_f1	Sokeywordtag wurde siekeywordtag zumindest von den 1500 Konferenzteilnehmern aus 63 Ländern 	interpretiert 	. 
interpretieren_s7733_f1	Daß die holländische Regierung vergangenen Freitag Lubbers offiziell für den Nato-Spitzenposten nominierte , wird in Kopenhagen als Flucht nach vorne 	interpretiert 	. 
interpretieren_s8407_f1	Verheugenkeywordtag habe die Worte des Generalinspekteurs falsch 	interpretiert 	. 
interpretieren_s10058_f1	Nur der Meister selbst 	interpretiert 	sein Ausstellungsstück als Aufschwungsmodell . 
interpretieren_s11628_f1	Würde man Erwachsene befragen , wie häufig siekeywordtag in ihrem privaten oder beruflichen Alltag Gedichtekeywordtag 	interpretieren 	, chemische Reaktionen auswerten oder Kugeln stoßen , so käme man zu ähnlich kümmerlichen Ergebnissen . 
interpretieren_s13820_f1	Anderskeywordtag wäre der massive Abbau von Arbeitsplätzen aus Gründen der Wettbewerbsfähigkeit nicht zu interpretieren . 
interpretieren_s13824_f1	Der Europäische Gerichtshof aber 	interpretiert 	diese Ausklammerung als `` Ausnahme '' . 
interpretieren_s14612_f1	Deren Mängel würden offenkundig , wenn Frankreich etwa die Schengener Konvention so 	interpretiere 	, daß eine Schließung nationaler Grenzen mit ihr übereinstimme . 
interpretieren_s17806_f1	Die angesprochenen Trends können für die derzeitige Situation nicht verallgemeinernd so 	interpretiert 	werden , daß sie alle sozialen Schichten in gleicher Weise erfaßt hätten . 
interpretieren_s22237_f1	Damit spreche die Gewerkschaft erstmals offen aus , daß Lohnzurückhaltung eine unerläßliche Voraussetzung für den Abbau der Arbeitslosigkeit sei , 	interpretiert 	VDMA-Hauptgeschäftsführer Hans-Jürgen Zechlin den Vorstoß in einem FR-Gespräch . 
interpretieren_s25168_f1	Pekingkeywordtag 	interpretierte 	siekeywordtag als Abrücken von einer strikten Ein-China-Politik . 
interpretieren_s25248_f1	Ebenso wie Musawjan hatten iranische Medien die Verschiebung der Konferenz als Zeichen der Anerkennung Kinkels für die Bedeutung Irans 	interpretiert 	. 
interpretieren_s26139_f1	Mankeywordtag könnte mit gutem Grund diese Entwicklung als Ausdruck dessen 	interpretieren 	, daß Preismechanismen selbstregulierend die ökologischen Grenzen des Wachstums im System so reproduzieren , daß das Gleichgewicht zwischen Ökonomie und Ökologie im großen und ganzen erhalten blieb . 
interpretieren_s26284_f1	Kindgemäßkeywordtag , 	interpretiert 	von Erwachsenen 
interpretieren_s26297_f1	`` Kindgemäß bedeutet ja immer , daß ich als Erwachsener 	interpretiere 	, was dem Kind gemäß ist . '' 
interpretieren_s28590_f2	Und die seien der Bitte nach `` flexiblerer Arbeitszeit '' und dem Verzicht auf zwölf Tage Freizeit , einem `` Meilenstein zur intelligenten Kostensenkung '' , gerne nachgekommen , 	interpretiert 	mankeywordtag in der Betriebszentrale . 
interpretieren_s29580_f1	Polens Verfassungsgericht wies die Bitte von Justizminister Jerzy Jaskiernia zurück , die Vorschriften des Antikorruptionsgesetzes `` eindeutig zu interpretieren '' , als unbegründet zurück . 
interpretieren_s34198_f1	Ein Sprecher der Bundestagsfraktion 	interpretierte 	den Beschluß der Delegierten der Agentur Reuter zufolge so , daß sich der Parteitag nicht auf ein kategorisches Nein zum `` Tornado '' -Einsatz festgelegt habe . 
interpretieren_s35648_f1	Das Geheimnis dieses Erfolgs : Der Text besteht aus vagen Kompromißformeln , diekeywordtag jederkeywordtag so 	interpretiert 	, wie er will . 
