investieren_s593_f1	1,5 Millionen Mark hat erkeywordtag 	investiert 	. 
investieren_s674_f1	In diesem Jahr werde die Chemieindustrie jenseits von Elbe und Werra voraussichtlich 1,6 Milliarden Mark 	investieren 	, während es in der vergangenen Periode eine Milliarde gewesen sei . 
investieren_s705_f1	Nach der voraussichtlichen Unterzeichnung eines Abkommens 1993 könnten den Briten zufolge in den nächsten zehn Jahren über drei Milliarden Dollar 	investiert 	werden . 
investieren_s878_f1	Der russische Präsident Boris Jelzin warf den Japanern im Gegenzug vor , siekeywordtag hätten `` noch keinen Yen oder keinen Cent in Rußland 	investiert 	'' . 
investieren_s1004_f1	`` Es geht nicht an , daß auf der einen Seite Handelsketten unsere Waren boykottieren , West-Baufirmen im Osten den Maurern die Arbeit wegnehmen , und auf der anderen Seite bei uns die Arbeitsplätze zum Teufel gehen , weil hier keinerkeywordtag 	investiert 	. '' 
investieren_s3865_f1	Allein 403 Milliarden Mark müßten nach Angaben Beckers in die ostdeutschen Verkehrswege 	investiert 	werden , darunter 240 Milliarden Mark in den Straßenbau . 
investieren_s5083_f1	`` Wir sagen nicht , 	Investiert 	nicht ' - wir sagen nur : , Wartet noch ein bißchen ' . '' 
investieren_s5148_f1	- Im Westen Deutschlands wurden in den vergangenen Jahren mehr 	investiert 	als in den USA , in Großbritannien und in Italien . 
investieren_s5153_f1	( ... ) Fünf von sechs D-Mark wurden in Standorte hier in Deutschland 	investiert 	. 
investieren_s5156_f1	Es ist keine Schwäche , wenn die Nation , die pro Kopf weltweit am meisten exportiert , auch im Ausland 	investiert 	und auch dort Arbeitsplätze schafft ! 
investieren_s5992_f1	Der Zugang müsse offen sein , `` sonst wird da niemandkeywordtag 	investieren 	'' . 
investieren_s6713_f1	Siemenskeywordtag 	investiert 	in Fernost 
investieren_s7156_f1	Energiekonzernekeywordtag 	investieren 	Milliardenkeywordtag in die Modernisierung der Kraftwerke / 
investieren_s7191_f1	Der dortige Stromversorger Bewag 	investierte 	mehr als 550 Millionen Mark , die Anlage geht Ende nächsten Jahres ans Netz . 
investieren_s7749_f1	Bis heute sind in den Standort , dessen Kapazitäten voll ausgelastet sind , 60 Millionen Mark 	investiert 	worden . 
investieren_s9129_f1	Umgerechnet knapp 300 000 Mark will die Armee in den Kopfschutz 	investieren 	. 
investieren_s13304_f1	`` Um die 600 Gulden muß man als Anfänger schon 	investieren 	'' , sagt Theo . 
investieren_s14739_f1	Rund 2,9 Milliarden Mark 	investierten 	die Rheinländer in Sachanlagen . 
investieren_s15285_f1	Bei Verwirklichung des Vorhabens könnten innerhalb von etwa fünf Jahren mehrere Milliarden Mark in der Volksrepublik 	investiert 	werden , bestätigt er ( siehe FR vom 18. 10. ) . 
investieren_s15761_f1	Bahnkeywordtag 	investiert 	massiv / 
investieren_s15985_f1	Die im GdW zusammengeschlossenen Verbände und Unternehmen könnten sich nach den Worten Steinerts verpflichten , bei einer Anhebung der Mieten auf das ortsübliche Niveau dadurch erzielte höhere Einnahmen wieder in Neubau und Modernisierung zu investieren . 
investieren_s16282_f1	Es könne den Geschäften nicht zugemutet werden , für eine kurze Übergangszeit teuer zu investieren . 
investieren_s19759_f1	Die Menschen müßten wissen , wie lange siekeywordtag 	investieren 	und wie sie die Laufzeit von Krediten wählen sollten . 
investieren_s19942_f2	Da Deutschland weder Rohstoffe wie Erze und Erdöl besitzt , haben wir nur eine Chance , wenn im gleichen Maße wie die Wirtschaft in die Technik investiert , auch in Menschen 	investiert 	wird . 
investieren_s20041_f1	Das Geld , daskeywordtag mankeywordtag dort oder eben in Straßburg 	investieren 	würde , käme besser einer europäischen Produktionsförderung zugute , damit die Filme zahlreicher werden , die man feiern könnte . 
investieren_s21748_f1	Obwohl die Krise BMW kalt erwischte , zweifelt Baumgartner die Entscheidung , 170 Millionen Dollar zu investieren , nicht an . 
investieren_s22807_f1	Preussag berichtet über den Bau eines Klärwerks in Qingdao für eine zweistellige Millionensumme sowie über eine Gemeinschaftsfirma von Preussag Noell mit einem chinesischen Partner , diekeywordtag 70 Millionen Mark in eine Stahlbaufertigung 	investieren 	soll . 
investieren_s23213_f1	So viel Energie die CDU-Spitze auf das `` Einhalten einer messerscharfen Trennlinie zur PDS '' ( Hintze ) verwendet , so viel Kraft will die Union in das Bemühen um Wähler dieser Partei 	investieren 	. 
investieren_s24057_f1	Als Grund für Staat und Wirtschaft , in die Informationsgesellschaft zu investieren , wird die internationale Wettbewerbsfähigkeit genannt . 
investieren_s24393_f1	Da verwundert es nicht , daß die Firma Colt , die derzeit nur 16 Leute in Deutschland beschäftigt , bis Silvester zehn Millionen und in den kommenden drei Jahren 50 Millionen Mark 	investieren 	muß . 
investieren_s25753_f1	Da VWkeywordtag in neue Produktlinien und die Steigerung der Produktivität in dem Subkontinent 	investieren 	müsse , hält es Adelt für möglich , daß die Dividendenzahlungen des Ablegers an die Mutter künftig geringer als bisher ausfallen . 
investieren_s25754_f1	In Südamerika 	investiert 	die Gruppe den Angaben zufolge jährlich rund 600 Millionen Mark . 
investieren_s25755_f1	Unesco protestiert - Shellkeywordtag 	investiert 	
investieren_s25759_f1	Der Mineralölkonzern Shell will weiter in dem afrikanischen Staat 	investieren 	. 
investieren_s25764_f1	Der britisch-niederländische Ölkonzern Shell will ungeachtet der Hinrichtungen in Nigeria weiter in dem westafrikanischen Land 	investieren 	. 
investieren_s26579_f1	Amoco und OK , diekeywordtag bereit sind , bis zu einer Milliarde Dollar in das Projekt zu investieren , sollen , wenn das Öl erst einmal sprudelt , 90 Prozent der Gewinne einsacken dürfen . 
investieren_s27056_f1	Dieserkeywordtag 	investiert 	in Mark-Kurzläufer mit niedrigen Kupons und geht wechselkursgesicherte Engagements in Fremdwährungen ein . 
investieren_s28740_f1	Drei Millionen Mark wurden in den `` Öko-Trimm '' 	investiert 	. 
investieren_s29154_f1	In Forschung und Entwicklung werde zu wenig 	investiert 	. 
investieren_s29937_f1		Investiert 	wurden 2,2 Milliarden ( plus zehn Prozent ) . 
investieren_s29944_f1	Der Medizintechnik- und Pharmakonzern Fresenius will künftig nur noch jenseits der Grenzen in Erweiterungsprojekte 	investieren 	, berichtet Firmenchef Gerd Krick . 
investieren_s30419_f1	France Telecom will nun gemeinsam mit dem defizitären Olivetti-Konzern dessen Tochterfirma Infrostrada neu beleben , diekeywordtag in den nächsten beiden Jahren rund 180 Millionen Mark in dem Mittelmeerland 	investieren 	soll . 
investieren_s30488_f1	`` Wo wird denn noch hierzulande in Industrieproduktion 	investiert 	? '' 
investieren_s30530_f1	1994 	investierte 	die öffentliche Hand bundesweit 101 Milliarden Mark in Gebäude , Kanäle , Straßen , Kläranlagen und andere Infrastrukurprojekte . 
investieren_s31055_f1	Die Wolfsburger wollen dort bis 1997 rund 365 Millionen Mark 	investieren 	. 
investieren_s31248_f1	Zum Ausbau des Geschäftes der beiden Zweige sollen binnen fünf Jahren 800 Millionen Mark 	investiert 	werden , in deren Gefolge 2000 Stellen entstehen könnten . 
investieren_s31249_f1	`` Wir haben Dolores ( das Abbauprogramm , die Red. ) schon hinter uns '' , und `` wirkeywordtag 	investieren 	massiv '' , sagte Vorstand Werner Heinzmann . 
investieren_s31813_f1	120 Millionen Mark werden 	investiert 	. 
investieren_s34820_f1	Moderne sozialdemokratische Wirtschaftspolitik darf und braucht sich auf keinen neuen , diesmal globalen Manchesterkapitalismus einlassen , in dem sich nationale Arbeitnehmerschaften gegenseitig die Arbeit wegnehmen , in dem ohne Rücksicht auf Bürgerkriege , Umweltkatastrophen und kulturellen Verfall produziert und gearbeitet , 	investiert 	und konsumiert wird . 
investieren_s35008_f1	Dann werden wachsende Gewinne , weil es keine wachsende Kaufkraft und Nachfrage gibt , nicht produktiv 	investiert 	; 
investieren_s36226_f1	Wieviel deutsche Unternehmen bisher genau in Vietnam 	investiert 	haben , ist schwer zu errechnen . 
investieren_s36625_f1	Binnen fünf Jahren sollen rund 100 Millionen Mark in die Hauptgeschäftsstelle für Europa 	investiert 	werden , sagt der Präsident der P. T. Finland , Pekka Vennamo . 
investieren_s37225_f1	Werkeywordtag bei der Emission im Jahr 1991 hundert Pfund in den Traditionsverein mit der riesigen Fangemeinde 	investierte 	, kann sich heute 977 Pfund auszahlen lassen . 
investieren_s37239_f1	Fast die Hälfte dieses Betrages hat Ex-Coach Kevin Keegan in seiner knapp fünfjährigen Amtszeit in neue Spieler 	investieren 	dürfen . 
investieren_s37444_f1	Nach wie vor 	investiere 	die Gruppe auch von dem gestiegenen Volumen 44 Prozent in der Heimat , allerdings wiederum in Ersatz- und Rationalisierungsvorhaben . 
investieren_s37776_f1	Um den zaudernden Wirtschaftsleuten ihre Scheu zu nehmen in den `` Boomländern '' des Subkontinents - Argentinien , Brasilien und Chile - zu investieren , trommelte der Bayer eine Mittelstandsdelegation zusammen , mit der er derzeit den Süden Südamerikas vom Atlantik bis zum Pazifik bereist . 
investieren_s38643_f1	Bis Dezember-Ultimo 	investierte 	die im Herbst 1993 gegründete Wingas 3,7 Milliarden Mark . 
investieren_s38811_f1	Bis 2000 soll der neue Eigner 480 Millionen Mark 	investieren 	. 
investieren_s39903_f1	Die Sparer bevorzugten zuletzt `` Töpfe '' , diekeywordtag außerhalb Deutschlands 	investierten 	. 
