kandidieren_s11_f1	Allerdings glaubt fast die Hälfte der Chief Executives , daß Perot durchaus Chancen habe , die Wahl im November zu gewinnen , wenn erkeywordtag denn 	kandidiert 	. 
kandidieren_s3030_f1	Militärregierung ließ nur zwei selbst gegründete Parteien für das neue Parlament 	kandidieren 	/ 
kandidieren_s9655_f1	Courage bringt mit , werkeywordtag gegen Hubert Weinzierl 	kandidiert 	, denn es könnte als Versuch der `` Demontage '' ausgelegt werden . 
kandidieren_s10094_f1	Gottscholkeywordtag 	kandidiert 	nach Angaben des Verbandes auf eigenen Wunsch nicht mehr . 
kandidieren_s10762_f1	Powellkeywordtag 	kandidiert 	nicht 
kandidieren_s10764_f1	Der Ex-Generalstabschef Colin Powell hat am Mittwoch angekündigt , erkeywordtag werde bei den Präsidentenwahlen in den USA nicht 	kandidieren 	. 
kandidieren_s10913_f1	`` Wer glaubt , er ist besser , derkeywordtag muß es sagen und 	kandidieren 	und darf nicht hinterher rumnölen . '' 
kandidieren_s13629_f1	Daher werde erkeywordtag 1996 weder für das Amt des Präsidenten noch für ein anderes politisches Amt 	kandidieren 	. 
kandidieren_s24215_f1	Bei den für Ende Dezember geplanten Parlamentswahlen sollen siekeywordtag auf der Liste von Cillers konservativer Partei des wahren Weges ( DYP ) 	kandidieren 	. 
kandidieren_s24228_f1	So soll der Chef der Privatisierungsbehörde , Ufuk Söylemez , 	kandidieren 	. 
kandidieren_s25382_f1	ichkeywordtag 	kandidiere 	nämlich . '' 
kandidieren_s27087_f1	Außer dem Armeekandidaten Zeroual 	kandidieren 	die drei absoluten Wahlverlierer von 1991 : Scheich Mahfoud Nahnah von der islamisch-moderaten `` Bewegung für eine islamische Gesellschaft '' Hamas , Said Sadi von der kabylisch-modernistischen `` Sammlungsbewegung für Kultur und Demokratie '' RCD und Noureddine Boukrouh von der `` Algerischen Erneuerungspartei '' PRA , die von einem modernen Islam redet . 
kandidieren_s27694_f1	Mit seiner Rede beeindruckte der saarländische Ministerpräsident den Parteitag so stark , daß erkeywordtag von einer Delegierten aufgefordert wurde , gegen Rudolf Scharping für den Parteivorsitz zu kandidieren . 
kandidieren_s27704_f1		Kandidiere 	für den Parteivorsitz . '' 
kandidieren_s28053_f1	Auch Scharping selbst erklärte , daß erkeywordtag 	kandidieren 	wolle . 
kandidieren_s30285_f1	`` Ich habe heute morgen Oskar gefragt , ob erkeywordtag bereit ist zu kandidieren . '' 
kandidieren_s30287_f1	Er selber , so steigert Scharping die Spannung weiter , er selber halte sich an den Vorstandsbeschluß vom 16. Oktober und 	kandidiere 	. 
kandidieren_s30289_f1	`` Oskar hat auf meine Frage hin erklärt , daß erkeywordtag ebenfalls 	kandidieren 	wird . '' 
kandidieren_s30340_f1	Jungsozialisten aus Ostwestfalen und Baden-Württemberg sammelten Unterschriften für einen Antrag , mit dem Lafontainekeywordtag aufgefordert werden sollte , als Parteichef zu kandidieren . 
kandidieren_s30344_f1	`` 	Kandidiere 	für den Parteivorsitz ! '' 
kandidieren_s30867_f1	Für weitere 37 Vorstandsplätze 	kandidierten 	49 Sozialdemokraten . 
kandidieren_s34473_f1	Erkeywordtag müsse seine Absicht , erneut zu kandidieren , `` nach diesem Vorgang überdenken '' , sagte Häßler , der auch stellvertretender Vorsitzender der CDU-Landtagsfraktion ist . 
kandidieren_s36341_f1	Theoretisch könnte auch Dudajew 	kandidieren 	; 
kandidieren_s37921_f1	Wegen Unstimmigkeiten mit dem einstigen Bürgermeister Klaus Wedemeier habe der SPD-Politiker ihnkeywordtag 1993 mit Erfolg aufgefordert , nicht wieder für den Gremienvorsitz zu kandidieren , so Scheider . 
