Konsequenz_s480_f1	Wenn auch viele Kubaner ihre Teilnahme ohnekeywordtag 	Konsequenzen 	verweigern konnten , so wurde Violeta Romeros hartnäckige Ablehnung letztlich für ihren Rausschmiß aus der Partei benutzt , erzählt ihr Ehemann . 
Konsequenz_s962_f1	Die Geschichte des ANC , `` sein Morden unschuldiger Zivilisten , Frauen und Kinder , seine barbarischen Halskrausen-Exekutionen , seine Folterungen und Morde in Gefangenenlagern und sein völliges Desinteresse an den Konsequenzenkeywordtag von Massenaktionen '' würden den ANC-Mitgliedern jegliche moralische Berechtigung nehmen , mit dem Finger auf andere zu zeigen . 
Konsequenz_s1002_f1	RUDOLF KRAUSE , ostdeutscher CDU-Bundestagsabgeordneter , hat alskeywordtag 	Konsequenz 	aus mangelnder Investitionsbereitschaft einen Boykott westdeutscher Waren in den neuen Ländern befürwortet . 
Konsequenz_s2030_f1	Da Kohl aber mit denkeywordtag deutschenkeywordtag Hochzinsenkeywordtag alskeywordtag 	Konsequenz 	der `` Einheit auf Pump '' nicht nur der eigenen Wirtschaft den Aufschwung erschwert , sondern auch die der Partnerländer mit Gewichten belastet , kann Bush diesmal für einen Rollentausch sorgen und den Kanzler auf einer `` Anklagebank '' seinen Morgenkaffee einnehmen lassen . 
Konsequenz_s2170_f1	Das Unternehmen sieht sich nach Vorstandsangaben gezwungenkeywordtag , weitreichende Konsequenzenkeywordtag zu ziehenkeywordtag , um seinen Bestand zu sichern . 
Konsequenz_s2814_f1	Aufseherkeywordtag ziehenkeywordtag Konsequenzenkeywordtag aus BCCI-Skandal 
Konsequenz_s2827_f1	Aus diesen und anderen einschlägigen Erfahrungen ziehenkeywordtag die Aufseher mit ihren vier Mindestanforderungen , bei denen es sich freilich durchweg um Soll- oder Kann-Vorschriften handelt , 	Konsequenzen 	. 
Konsequenz_s3121_f1	Während Premierminister John Major gestern am Rande des G-7-Gipfels in München Bundeskanzler Helmut Kohl und den italienischen Regierungschef Giuliano Amato zur weiteren Kooperation am ``Jäger90''-Projekt zu bewegen suchte , erörterte in London Verteidigungsminister Malcolm Rifkind mit seinem deutschen Kollegen Volker Rühe die Konsequenzenkeywordtag des deutschen Rückziehers . 
Konsequenz_s3522_f1	Darauskeywordtag politischekeywordtag Konsequenzenkeywordtag zu ziehenkeywordtag , täte not , bevor der bosnische Bürgerkrieg doch noch in einen internationalen Konflikt umschlägt . 
Konsequenz_s3880_f1	Die Strukturänderung seikeywordtag notwendige 	Konsequenz 	aus der `` dauerhaften Herausforderung '' , daß die Universitäten ein Drittel eines Altersjahrganges auszubilden hätten , sagte der Präsident der HRK , Hans-Uwe Erichsen . 
Konsequenz_s4386_f1	Der magere Frauenanteil istkeywordtag auch 	Konsequenz 	aus der Absicherung aller Direktwahlkreise auf der Landesliste . 
Konsequenz_s5000_f1	Wenn ich mir selbst im Falle Bernau einen gravierenden Fehler hätte vorwerfen müssen , wäre daskeywordtag nicht ohnekeywordtag Konsequenzkeywordtag gebliebenkeywordtag . 
Konsequenz_s7541_f1	Tiefgreifendere Konsequenzenkeywordtag sind dabei bisher ausgeblieben . 
Konsequenz_s9384_f1	Vor dem Hintergrund der Tatsache , daß die hier vorgestellte Konzeption eine Vereinfachung von Strukturen und Waffenmix - mit der erwünschten 	Konsequenz 	einer Dämpfung der rüstungsspezifischen Kostendynamik - vorsieht , darf dies als wesentlicher Beitrag zur Konsistenz und Verstetigung der Verteidigungsplanung gewertet werden . 
Konsequenz_s10057_f1	In Wirklichkeit nehmen gerade wieder einmal Wissenschaft und Wirtschaft Abschied von Illusionen über einen bevorstehenden Boom mit allen Konsequenzenkeywordtag für das Lochmuster in Waigels Zahlenkunstwerk . 
Konsequenz_s10091_f1	Der Arbeitgeberverband Gesamtmetall ziehtkeywordtag weitere personellekeywordtag 	Konsequenzen 	aus der Krise , in der er seit dem Streik in der bayerischen Metallindustrie vom Frühjahr steckt . 
Konsequenz_s10112_f1	Alskeywordtag 	Konsequenz 	aus dem Soldaten-Urteil des Bundesverfassungsgerichts erwägtkeywordtag die CDU eine Verschärfung des Strafrechts . 
Konsequenz_s10642_f1	Diesekeywordtag hätten alles vermieden , um Konsequenzenkeywordtag aus der Wahlschlappe zu ziehenkeywordtag . 
Konsequenz_s11531_f1	Für die demokratischen Strukturen und den Inhalt der russischen Verfassung hatkeywordtag daskeywordtag Konsequenzenkeywordtag . 
Konsequenz_s11653_f1	Wirkeywordtag ziehenkeywordtag daherkeywordtag die Konsequenzkeywordtag und treten zu den Wahlen nicht an , um anderen Gruppierungen den Weg nicht zu verbauen und damit die studentische Vertretung nicht zu lähmen . 
Konsequenz_s12510_f1	Erkeywordtag zogkeywordtag damitkeywordtag die 	Konsequenz 	aus dem Vorwurf , die Sicherheit des am Samstag in Tel Aviv bei einer Friedenskundgebung erschossenen israelischen Ministerpräsidenten Yitzhak Rabin sei vernachlässigt worden . 
Konsequenz_s12665_f1	Viel ernstere 	Konsequenz 	aus dem krassen Tonlagen-Wechsel : Es zeichnet sich eine neue Fluchtwelle ab . 
Konsequenz_s13795_f1	Neuerungen müssen vielmehr bei der Aufgabenbeschreibung für den Staat und dessen Verhältnis zum privaten Sektor beginnen , die Konsequenzenkeywordtag für die Reform der Verwaltung einbeziehen und die Folgen für das öffentliche Dienstrecht berücksichtigen . 
Konsequenz_s13809_f1	Daskeywordtag hättekeywordtag auch Konsequenzenkeywordtag für die Einstellungsvoraussetzungen . 
Konsequenz_s14617_f1		Konsequenz 	: `` Die Zusammenarbeit zwischen Deutschland und den deutschsprachigen Kantonen der Schweiz klappt besser als die mit Frankreich , obwohl die Schweiz nicht EU-Mitglied ist . '' 
Konsequenz_s17675_f1	Solange eine derartige - individuell und gruppenspezifisch durchaus verständliche - Risikoaversion vorherrscht beziehungsweise sich ausbreitet , die in der Wahrnehmung von Veränderung die etwaigen Gefährdungen deutlich sieht , die ebenfalls vorhandenen Chancen aber ausblendet , werden steigende modernisierungshemmende und strukturkonservierende Innovations- und Technikfeindlichkeit die Folge sein , mit der 	Konsequenz 	, daß staatliche Bemühungen zur Innovationsförderung , die dann eben nicht auf ein aufnahmebereites gesellschaftliches Klima stoßen , an wettbewerbspolitischer Schlagkraft verlieren . 
Konsequenz_s17825_f1	Was daskeywordtag inkeywordtag der Konsequenzkeywordtag gerade für die neuen Bundesländer bedeutetkeywordtag , die in vielen Regionen auf ihre wertschöpfungsintensiven Branchen wie die Chemie oder den Maschinenbau setzen ( müssen ) , läßt sich absehen . 
Konsequenz_s18657_f1	Und zweitens , weil die politische Tragweite und die rechtlichenkeywordtag Konsequenzenkeywordtag dieser Bestechungsaffäre überhaupt noch nicht absehbar sind . 
Konsequenz_s18950_f1	Sahlinkeywordtag zogkeywordtag damitkeywordtag die 	Konsequenzen 	aus der Kreditkarten-Affäre , die sie in den letzten Wochen viel von ihrer Popularität gekostet hat . 
Konsequenz_s19935_f1	Wir brauchen einen Dialog der Sozialpartner über die technologischen Entwicklungen , deren gesellschaftliche Auswirkungen und die Konsequenzenkeywordtag auf dem Arbeitsmarkt . 
Konsequenz_s22722_f1		Konsequenz 	für Sjögren : `` Wir schrecken vor keinem Material zurück , wenn es der Markt verlangt '' . 
Konsequenz_s22883_f2	`` Die Bundesrepublik muß sich entscheiden , ob sie einen Demokratisierungsprozeß aktiv gestalten will oder ein Prinzip der Ungleichheit tolerien will , mit all den gesellschaftlichenkeywordtag Konsequenzenkeywordtag , die daraus resultieren . '' 
Konsequenz_s23275_f1	Gründe für die Vernichtung von Tier- und Pflanzenarten seien beispielsweise das Bevölkerungswachstum , die Ausbreitung von Luft- und Wasserverschmutzung , die Mißachtung der Konsequenzenkeywordtag von Handlungen des Menschen und das Versagen der Wirtschaft , die den wahren Wert der Erhaltung der Artenvielfalt nicht erkenne . 
Konsequenz_s24055_f1	Darauskeywordtag ziehenkeywordtag Expertenkeywordtag zwei 	Konsequenzen 	: Deutschland lebt auf einem `` zu hohen Wohlstandsniveau '' und : Ohne Kaufkraft rechnet sich die Informationsgesellschaft nicht . 
Konsequenz_s26083_f1	2. Soziale Bewegungen leiten ihre Legitimation auch daraus ab , daß Parteienkeywordtag nicht imstandekeywordtag sind , Bürgeranliegen mitkeywordtag der gebotenenkeywordtag 	Konsequenz 	zu ihren eigenen zu machen . 
Konsequenz_s26311_f1	Montessoris Bild vom Kind hatkeywordtag weitreichende Konsequenzenkeywordtag für den Unterricht . 
Konsequenz_s26480_f1	Welche Konsequenzenkeywordtag hatkeywordtag daskeywordtag ? 
Konsequenz_s26632_f1	Er trat nicht mehr leibhaftig auf , war nur noch präsent über die technischen Vermittlungskanäle : Ein Künstler des technischen Zeitalters in allerkeywordtag 	Konsequenz 	. 
Konsequenz_s26987_f1	Im Namen des Parteivorstandes versprach er , daß alle Mitglieder der Parteiführung Konsequenzenkeywordtag ziehenkeywordtag würden . 
Konsequenz_s27435_f1	Von Seiten der Polizeiführung habe mankeywordtag inzwischen Konsequenzenkeywordtag gezogenkeywordtag . 
Konsequenz_s28003_f1	Die Union seikeywordtag eine 	Konsequenz 	der europäischen Einigung und eines gemeinsamen Marktes , sagte Delors . 
Konsequenz_s28064_f1	Nach Angaben von Bundesgeschäftsführer Franz Müntefering wird das Parteipräsidium unmittelbar nach der Abstimmung entscheiden , `` ob es Konsequenzenkeywordtag aus dieser Wahl geben muß '' . 
Konsequenz_s28321_f1	Parteichef Schlierer wertete den Austritt alskeywordtag zwangsläufige 	Konsequenz 	einer längeren Entwicklung , in deren Verlauf sich Schönhuber zunehmend von dem von der Partei für richtig befundenen Kurs entfernt hatte . 
Konsequenz_s29244_f1	Das ist ja vielleicht meine besondere Begabung , Konsequenzkeywordtag meines Darstellungstriebs oder sogar meines Größenwahns , daß ich immer wieder die Kraft aufbringe , die Bühne als einen Ort zu behaupten , an dem unterdrückte Fragen szenisch oder auch in Person gestellt werden . 
Konsequenz_s29323_f1	Er stellte fest , daß in Baden-Württemberg die Zahl der geriatrischen Betten in den letzten Jahren von 700 auf 895 erhöhtkeywordtag wordenkeywordtag seikeywordtag - mitkeywordtag der 	Konsequenz 	, daß die Kassen für die damit zusammenhängenden Ausgaben nun vom Bundesgesundheitsminister `` massiv geprügelt '' würden . 
Konsequenz_s29427_f1	Der Hinweis auf die Konsequenzenkeywordtag des Bereicherungs-Gedankens wird dann auch regelmäßig mit `` Übergangsschwierigkeiten , die langfristig zu beheben sind '' , abgetan . 
Konsequenz_s29704_f1	Und sogar `` deutlich stärker '' haben die Gewinne nach Steuern zugenommen , waskeywordtag vor allem eine 	Konsequenz 	des Standortsicherungsgesetzes warkeywordtag , das die Auflösung von in früheren Jahren gebildeten Rücklagen steuerlich begünstigte . 
Konsequenz_s30387_f1	Hennemannkeywordtag zogkeywordtag mit seinem Rücktritt die 	Konsequenzen 	aus einer schweren Vertrauenskrise . 
Konsequenz_s33272_f1	Nachdem alle Welt darin übereingekommen war , daß der unzweifelhafte Gute Mensch von Oberlahnstein eine professionelle Fehlbesetzung war , sollte ausgerechnet der , derkeywordtag darauskeywordtag die politisch-klugekeywordtag Konsequenzkeywordtag gezogenkeywordtag hatte ( und zugleich der einzige , der dazu in der Lage war ) , sich als intriganter `` Bösewicht '' offenbaren ? 
Konsequenz_s35108_f1	Die Gewerkschaft Leder zogkeywordtag die Konsequenzkeywordtag und löst sich auf . 
Konsequenz_s35400_f1	Die Delegierten des Landesparteitags folgten Schröder nur mit knapper Mehrheit - nachdem erkeywordtag ihnen mitkeywordtag persönlichen Konsequenzenkeywordtag gedrohtkeywordtag hatte . 
Konsequenz_s35866_f1	So gesehen ist der Anschlag in Pakistan von grauenvollerkeywordtag 	Konsequenz 	. 
Konsequenz_s37071_f1	Die Konsequenzkeywordtag der Überlegungen steht noch aus . 
Konsequenz_s38472_f1	Sinclairkeywordtag hat aus dem Aufstieg ihres Mannes , anders als während dessen erster Amtszeit , Konsequenzenkeywordtag gezogenkeywordtag : 
Konsequenz_s38699_f1	`` Großzügige Liquiditätshilfen '' wie im Fall Mexikos , gibt Lipp allenfalls zu Bedenken , bewahrten `` Schuldner und Gläubiger vor Verlusten und damit vor den Konsequenzenkeywordtag ihrer eigenen Entscheidungen '' . 
Konsequenz_s38860_f1	Am Montag werde der Aufsichtsrat über mögliche personelle Konsequenzenkeywordtag entscheiden . 
Konsequenz_s38889_f1	Die Hofpfisterei ziehtkeywordtag Konsequenzenkeywordtag und setzt rundum auf Bio . 
Konsequenz_s40246_f1	Die 	Konsequenz 	einer weiteren Niveausenkung wärekeywordtag für Schmähl , daß immer mehr Versicherte nur noch eine Rente erhielten , `` die niedriger ist als die Sozialhilfe '' . 
Konsequenz_s44172_f1	Die Konsequenzkeywordtag fällt allerdings halbherzig aus : 
Konsequenz_s48851_f1	Die 	Konsequenz 	von Braques künstlerischer Entwicklung hat die Kunstgeschichte zu einer verhängnisvollen Gleichsetzung seines Werkes mit dem Kubismus verleitet . 
