Kooperation_s1183_f1	Schäuble sagte am Samstag im Sender Freies Berlin , die Union wolle `` inkeywordtag der Fortsetzungkeywordtag der 	Kooperation 	mit den anderen europäischen Partnern Großbritannien , Spanien , Italien auf dem Stand der jetzigen Entwicklung zu einem billigeren , in seinen Anforderungen kostengünstigeren Flugzeug kommen '' . 
Kooperation_s2223_f1	Wörner hofft auf 	Kooperation 	
Kooperation_s3106_f1	Ost-Institut sieht Mängel bei 	Kooperation 	mit GUS 
Kooperation_s3109_f1	In der Gemeinschaft Unabhängiger Staaten ( GUS ) fehlt es an vielen notwendigen politisch-rechtlichen und ökonomisch-institutionellen Voraussetzungen für effektivere Hilfe und 	Kooperation 	des Westens . 
Kooperation_s3121_f1	Während Premierminister John Major gestern am Rande des G-7-Gipfels in München Bundeskanzler Helmut Kohl und den italienischen Regierungschef Giuliano Amato zur weiteren 	Kooperation 	am ``Jäger90''-Projekt zu bewegenkeywordtag suchte , erörterte in London Verteidigungsminister Malcolm Rifkind mit seinem deutschen Kollegen Volker Rühe die Konsequenzen des deutschen Rückziehers . 
Kooperation_s3131_f1	Eine solche Kursänderung biete `` die Chance für weitere 	Kooperation 	'' möglicherweise aller WEU-Staaten . 
Kooperation_s3550_f1	Eine solche Kursänderung biete `` die Chance für weitere 	Kooperation 	'' möglicherweise aller WEU-Staaten . 
Kooperation_s4506_f1	Die 	Kooperation 	erstrecktkeywordtag sich auf Entwicklung , Produktion und Marketing neuer leichter Wechselstrom-Dieselelektrik-Loks . 
Kooperation_s5162_f1	In Europa brauchen wir wirtschaftlichekeywordtag 	Kooperation 	anstelle gnadenloser Konkurrenz . 
Kooperation_s6022_f1	Mit 112 zu 95 Stimmen wurde dagegen die 	Kooperation 	mit der CDU im Römer knapp gebilligt . 
Kooperation_s6673_f1	Die BASF verstärktkeywordtag ihrekeywordtag internationalekeywordtag 	Kooperation 	im Pflanzenschutzgeschäft . 
Kooperation_s7557_f1	Eine solch unabweisbar notwendige 	Kooperation 	funktioniert nicht und kann nicht funktionieren , wenn ganze Bezirksämter , insbesondere in den Innenstadt-Bezirken , aus parteipolitischen Gründen aus dem Kommunikations- und Willensbildungsprozeß bewußt ausgegrenzt und Zeugnisse der `` kulturellen Geschichte der Ostberliner '' aus ideologischen Gründen plattgemacht und durch Stadtschlösser ersetzt werden sollen . 
Kooperation_s7752_f1	Die Firma , die sich als Branchenführer in Deutschland bezeichnet , erklärt ihren Erfolg unter anderem mit der engenkeywordtag 	Kooperation 	mit mehr als 300 Fachhändlern und der großen Fertigungstiefe . 
Kooperation_s8879_f1	`` Wer anderes will , wird mit der 	Kooperation 	des Bergbaus nicht rechnen können '' , sagte Spies und warnte vor der Hoffnung , mit rascher Stillegung `` schnell öffentliches Geld '' zusätzlich zu sparen . 
Kooperation_s9321_f1	- Neubelebung des aus kurzsichtigen Erwägungen aufgegebenen DAVID-Programms , das durch das EDV-gestützte Management der 	Kooperation 	von Artillerie und Sperrmitteln die Kontrolle weiter Räume bei relativ geringem Personaleinsatz ermöglicht . 
Kooperation_s9354_f1	- Eine dritte Möglichkeit bestünde darin , die erforderliche innere Balance der Luftstreitkräfte dadurch zu gewinnen , daß zielstrebig eine engerekeywordtag 	Kooperation 	bzw. Integration mit an modernen Jägern starken Luftwaffen von Nachbarländern ( z. B. Niederlande und Belgien ) gesucht wird . 
Kooperation_s9698_f1	Bei allem Willen zur Unabhängigkeit : Finanzkraft bezieht der NABU auch aus der 	Kooperation 	mit Wirtschaftsunternehmen . 
Kooperation_s9709_f1	Das ist auch bei der nächsten 	Kooperation 	so , wenn Bahn AG und BUND zusammenrücken . 
Kooperation_s11254_f1		Kooperationen 	und Firmenhochzeiten seien eine wichtige Reaktion auf den international verschärften Wettbewerb , meint der Hauptgeschäftsführer des Verbands Forschender Arzneimittelhersteller ( VFA ) , Frank Münnich . 
Kooperation_s11473_f1	zum ersten Mal in seiner Geschichte kann Europa zu einem Kontinent friedlicherkeywordtag 	Kooperation 	aller werden , deren Zusammenleben auf Gleichberechtigung , nicht auf Übermacht der einen über die anderen beruht . 
Kooperation_s14191_f1	Bereits im August hatte Schadt eine 	Kooperation 	mit dem Karstadt-Konzern angekündigt . 
Kooperation_s15204_f1	So hatte sich IG-Metall-Chef Klaus Zwickel die Reaktion auf sein Angebot zum `` Bündnis für Arbeit '' sicherlich nicht vorgestellt , daß er den kleinen Finger zur 	Kooperation 	reichte und daran nun über den Tisch gezogen werden soll . 
Kooperation_s16842_f1	So werde eine 	Kooperation 	Norddeutsches Küstenland finanziell gefördert aber keine bayerische . 
Kooperation_s18753_f1	Eine Schweizer Investmentbank erarbeitete ein Gutachten , das der 	Kooperation 	mit Partnern beziehungsweise deren Kapitalbeteiligung dienen soll . 
Kooperation_s23163_f1	Das Institut plädiert für `` eine neue Form der 	Kooperation 	zwischen den wichtigsten wirtschaftspolitischen Akteuren ( Staat , Bundesbank , Tarifparteien ) , um arbeitsplatzgefährdende Konflikte zwischen der Geld- , Finanz- und Lohnpolitik zu vermeiden '' . 
Kooperation_s24568_f1	Dankkeywordtag der Vereinbarung mit dem kalifornischen Chiphersteller und der bestehenden 	Kooperation 	mit Microsoft werde sein Haus , das bisher nur Profi-Rechner und für PC Monitore und Zubehör herstellt , das 50jährige Firmenjubiläum 1996 mit dem Einstieg in den Personalcomputer-Markt feiern . 
Kooperation_s27645_f1	Obwohl der bisherige Parteivorsitzende nicht davon ausgeht , ist eine 	Kooperation 	der SDL mit der HZDS künftig nicht auszuschließen . 
Kooperation_s28403_f1		Kooperation 	angeboten 
Kooperation_s28730_f1	So steht das Ökozentrum Werratal ferner für eine gelungene 	Kooperation 	von Ost- und Westdeutschen . 
Kooperation_s29328_f1	Nachdem die Theater von Wuppertal und Gelsenkirchen ihren Stadtverwaltungen für 1996 ein ansatzweise bereits jetzt praktiziertes Modell der engenkeywordtag 	Kooperation 	unterbreitet hatten ( die FR berichtete ) , erwägen nun ebenfalls in Hoffnung auf Landeszuschüsse Essen und Oberhausen , ihre Schauspielhäuser 1998 zu fusionieren ( siehe FR vom 14. 11. ) . 
Kooperation_s30071_f1	Beim Einkauf der Beteiligungsgesellschaften in der Gruppe ist eine `` stärkerekeywordtag 	Kooperation 	'' geplant . 
Kooperation_s30079_f1	Die Konzerne Boeing und McDonnell Douglas verhandeln über eine engerekeywordtag 	Kooperation 	, die zu einem Zusammenschluß der beiden großen Flugzeughersteller führen könnte . 
Kooperation_s30751_f1	Auf entsprechende Fragen reagierte Lafontaine am Nachmittag vor Journalisten mit dem Hinweis , daß er auf eine engekeywordtag 	Kooperation 	mit dem Oppositionsführer hinarbeiten wolle . 
Kooperation_s30844_f1	Nur knapp hat die neue 	Kooperation 	von CDU und SPD im Frankfurter Römer am Donnerstag abend ihre erste Bewährungsprobe überstanden . 
Kooperation_s32004_f1	Alle Expeditionen , Kameltrecks und Wanderungen zwischen Air-Gebirge und Téneré-Wüste werden in engerkeywordtag 	Kooperation 	mit den Tuaregs geplant und durchgeführt . 
Kooperation_s33377_f1	Um auf dieses Problem und die Notwendigkeit internationalerkeywordtag 	Kooperation 	bei der Bekämpfung des Kindersextoursimus hinzuweisen , wird Felizardo am 7. Dezember im Rahmen einer Anhörung vor den Mitgliedern des Deutschen Bundestages sprechen . 
Kooperation_s33575_f1	Erforderlich sei zudem die Einbindung Frankreichs in den Reformprozeß , das in einer auf 	Kooperation 	angelegten `` neuen Nato '' seinen Platz finden solle . 
Kooperation_s35380_f1	Für Trondsen basiert der Erfolg von Silicon Valley denn auch wesentlich auf zwei Faktoren : Der engenkeywordtag 	Kooperation 	von Staat , Wissenschaft und Wirtschaft sowie dem `` reichlich vorhandenen Risiko-Kapital '' . 
Kooperation_s35637_f1	Er versprach außerdem , die 	Kooperation 	innerhalb der Apec mit umgerechnet 150 Millionen Mark zu fördern . 
Kooperation_s35643_f1	Murayama betonte : `` Die wirtschaftliche und technologische 	Kooperation 	wird den freien Handel erleichtern und die Unterschiede zwischen einzelnen Ländern abbauen . '' 
Kooperation_s35890_f1	Anders als die auch zu Spionagezwecken einseitig national einsetzbaren Satelliten verfolgt die Luftüberwachung einen anderen Ansatz : den der 	Kooperation 	mit dem zu beobachtenden Staat . 
Kooperation_s36637_f1	Der US-Konzern steige dazu in die bereits bestehende 	Kooperation 	zwischen den Stuttgartern und der kanadischen Ballard Power Systems ( Vancouver ) ein , teilen die Unternehmen mit . 
Kooperation_s40428_f1	Während das Institut nach wie vor BHW favorisiere , sei sein Partner Deutsche Post für eine 	Kooperation 	mit Wüstenrot . 
Kooperation_s40443_f1	Bestehende 	Kooperationen 	von Siemens mit anderen Anbietern von Netzprodukten würden durch die neue Allianz nicht tangiert , betonen die Firmen . 
Kooperation_s40898_f1	Die 	Kooperation 	mit Partnern in Fernost sei gerade intensiviert worden . 
Kooperation_s41656_f1	Diese Tage treffen sich Manager beider Konzerne , um über eine 	Kooperation 	, die über Stahl hinausgeht , zu verhandeln . 
Kooperation_s43561_f1	Die Financial Times hatte kolportiert , die Häuser sprächen über eine 	Kooperation 	. 
Kooperation_s43899_f1	Diese neue strategische 	Kooperation 	soll in Zukunft noch weitere Früchte tragen . 
Kooperation_s43912_f1	Die Zukunft gehöre strategischen 	Kooperationen 	dieser Art , lobt der hiesige Crédit-Geschäftsführer Herbert Frohne . 
Kooperation_s49556_f1	Inkeywordtag 	Kooperation 	mit den USA bemüht sich die EU um eine Kompromißformel für neue Verhandlungen zwischen Israel und Syrien . 
Kooperation_s50443_f1	Die Nato , plötzlich ohne Gegner , begegnete ihrer Rechtfertigungskrise mit einer Reihe von 	Kooperations- 	und Partnerschaftsangeboten , auch um sich die auf Beitritt drängenden mittel- und osteuropäischen Staaten erst einmal auf Armeslänge zu halten . 
Kooperation_s50470_f1	Eine 	Kooperation 	mit Moskau bei Krisen und Kriegen wie in Bosnien wird schwerer werden . 
