Mitstreiter_s4224_f1	Die Menschenrechtsorganisation amnesty international hatte die sofortige Freilassung Saro-Wiwas und seinerkeywordtag ebenfalls zum Tode verurteilten acht Mitstreiterkeywordtag verlangt und den Shell-Konzern aufgefordert , seinen Einfluß bei der nigerianischen Regierung geltend zu machen . 
Mitstreiter_s5920_f1	Mit diesem haben sich seinkeywordtag frühererkeywordtag christdemokratischer 	Mitstreiter 	und Ex-Minister Claudio Vitalone sowie die Mafia-Bosse Pippo Calo und Gaetano Badalamenti zu verantworten , die den Mord organisiert haben sollen . 
Mitstreiter_s9810_f1	Das Todesurteil gegen Ken Saro-Wiwa , den nigerianischen Buch- und Bühnenautor , Filmproduzenten und Umweltaktivisten , ist fünftausend Kilometer nördlich seines Landes , im West Yorkshire Playhouse der nordenglischen Stadt Leeds , unversehens zum unsichtbaren Hintergrund der Uraufführung eines neuen Theaterwerkes seineskeywordtag weltberühmten Landsmannes , Kollegen und 	Mitstreiters 	Wole Soyinka geworden ; 
Mitstreiter_s10584_f1	Offensichtlich hatte sich der frischgekürte Präsident damals verpflichtet gefühlt , viele Mitstreiterkeywordtag für ihren Einsatz mit Regierungsposten zu belohnen . 
Mitstreiter_s11077_f1	Trotz internationaler Proteste hat Nigerias Militärjunta das Todesurteil gegen den Dichter Ken Saro-Wiwa und acht seinerkeywordtag Mitstreiterkeywordtag bestätigt . 
Mitstreiter_s11081_f1	Auch die Todesurteile gegen die acht Mitstreiterkeywordtag Saro-Wiwaskeywordtag seien bestätigt worden , sagte Malu . 
Mitstreiter_s13359_f1	Einen Tag vor Tagungsbeginn der Regierungschefs der 52 Commonwealthländer im neuseeländischen Auckland ( CHOGM ) nannte der britische Regierungschef John Major die Urteile gegen den Schriftsteller und Bürgerrechtler Ken Saro-Wiwa und acht seinerkeywordtag Mitstreiterkeywordtag `` fehlerhaft '' und bat um Gnade . 
Mitstreiter_s13579_f1	Die Junta von Abacha hatte einstimmig der Hinrichtung des Schriftstellers Ken Saro-Wiwa und acht seinerkeywordtag Mitstreiterkeywordtag zugestimmt . 
Mitstreiter_s19439_f1	Der nigerianische Oppositionelle Ken Saro-Wiwa und acht seinerkeywordtag Mitstreiterkeywordtag sind am Freitag im Gefängnis von Port Harcourt hingerichtet worden . 
Mitstreiter_s19447_f1	Die nigerianische Militärregierung hatte am Mittwoch die Todesurteile gegen den mit dem alternativen Nobelpreis ausgezeichneten Schriftsteller und seinekeywordtag Mitstreiterkeywordtag bestätigt . 
Mitstreiter_s19696_f1	Mit diplomatischen und wirtschaftlichen Strafen gegen Nigerias Militärregime haben Staaten weltweit auf die Hinrichtung des Schriftstellers und Bürgerrechtlers Ken Saro-Wiwa und acht seinerkeywordtag Mitstreiterkeywordtag reagiert . 
Mitstreiter_s19704_f1	London wolle seine EU-Partner bitten , sich dem Schritt anzuschließen , sagte Major in Auckland und schloß weitere Strafmaßnahmen aus Protest gegen die kaltblütige , `` provokative '' Hinrichtung Saro-Wiwas und seinerkeywordtag Mitstreiterkeywordtag nicht aus : 
Mitstreiter_s25765_f1	Der Afrika-Koordinator von Shell , Dick van den Broek , gab den Gegnern des Militärregimes eine Mitschuld an der Exekution Saro-Wiwa und acht seinerkeywordtag Mitstreiterkeywordtag . 
Mitstreiter_s27261_f1	Erst der barbarische Akt selbst , der ihn und acht Mitstreiterkeywordtag ins Jenseits beförderte , schaffte etwas Öffentlichkeit für Nigerias `` innere Angelegenheit '' . 
Mitstreiter_s28433_f1	Das Europa-Parlament hat als Reaktion auf die Hinrichtung des nigerianischen Bürgerrechtlers Ken Saro-Wiwa und acht seinerkeywordtag Mitstreiterkeywordtag ein Ölembargo gegen das Militärregime in Abuja gefordert . 
Mitstreiter_s29375_f1	Er gehörte zu den alten Kriegsveteranen und langjährigen revolutionären Mitstreiternkeywordtag der KPC . 
Mitstreiter_s31272_f1	ai befürchtet , daß mindestens 17 von ihnen wegen derselben Morde vor einem Militärtribunal angeklagt werden , für die bereits der nigerianische Schriftsteller Ken Saro-Wiwa und acht seinerkeywordtag Mitstreiterkeywordtag in der vergangenen Woche nach einem unrechtmäßigen Prozeß gehenkt worden waren . 
Mitstreiter_s42108_f1	Louis-Dreyfus und seinkeywordtag 	Mitstreiter 	Christian Tourres halten je 6,5 Prozent des Kapitals . 
Mitstreiter_s45156_f1	Kozlovacki und seinekeywordtag Mitstreiterkeywordtag halten das Rathaus rund um die Uhr besetzt . 
Mitstreiter_s47891_f1	Er möchte , anders als viele seinerkeywordtag auf die `` kommunistische Gefahr '' fixierten einstigen Mitstreiterkeywordtag , selbst zu einer Zusammenarbeit zwischen SPD und PDS `` nicht für alle Zeiten sagen : Das geht nicht '' . 
Mitstreiter_s48084_f1	Und wie das bei Generälen so ist : Aguinaldo sollte alle seinekeywordtag Mitstreiterkeywordtag und Widersacher überleben . 
