plaedieren_s119_f1	Jaschke : Ichkeywordtag 	plädiere 	für eine offensive politische Auseinandersetzung , wobei zu berücksichtigen ist , daß die Rechtsaußenparteien keine Programmparteien sind , sondern sie sind wesentlich Weltanschauungsparteien . 
plaedieren_s142_f1	Ichkeywordtag 	plädiere 	- im Gegensatz etwa zu Brumlik ( Stadtverordneter der Grünen in Frankfurt , Red. ) und anderen - dafür , in den Parlamenten zu respektieren , daß diese Abgeordneten frei gewählt sind . 
plaedieren_s939_f1	In Anlehnung an den evangelischen Theologen Dietrich Bonhoeffer , der von den Nazis ermordet worden ist , und die katholischen Theologen Karl Rahner und Johann Baptist Metz , die in ihren Kirchen für produktive Unruhe gesorgt haben , 	plädiert 	erkeywordtag für eine `` Metaphysik von unten '' im Sinne des `` Für-andere-Dasein '' . 
plaedieren_s1786_f1	Martin Khor vom Dritte-Welt-Netzwerk Malaysias 	plädierte 	für eine Demokratisierung der Weltökonomie-Institutionen Gatt , Weltbank , Internationaler Währungsfonds IWF und nicht zuletzt des G-7-Gipfels selbst , auf dem die Entwicklungsländer ebenfalls vertreten sein sollten . 
plaedieren_s1874_f1	Am schwungvollsten war wieder Debattenprofi Glotz , derkeywordtag indirekt ebenfalls für Ämterbegrenzungen 	plädierte 	: 
plaedieren_s1980_f1	Martin Khor vom Dritte-Welt-Netzwerk Malaysias 	plädierte 	für eine Demokratisierung der Weltökonomie-Institutionen Gatt , Weltbank , IWF und nicht zuletzt des G-7-Gipfels selbst , auf dem die Entwicklungsländer ebenfalls vertreten sein sollten . 
plaedieren_s3060_f1	Demgegenüber lehnen die USA und Japan eine Vergabe der auf 700 bis 800 Millionen Dollar bezifferten G-7-Mittel über internationale Organisationen ab und 	plädieren 	für koordinierte zweiseitige Hilfsprogramme . 
plaedieren_s3870_f1	Becker , der auch Vorstands-Chef des Holzmann-Konzerns ist , 	plädierte 	erneut für eine Vereinfachung des Planungsrechts zur Beschleunigung von Projekten und effizientere Vergabeverfahren . 
plaedieren_s8312_f1	Der israelische Geheimdienst Schin Bet 	plädierte 	dafür , keinen Anwalt zu dem Attentäter zu lassen , damit geklärt werden könne , ob der Student tatsächlich allein handelte . 
plaedieren_s8887_f1	Erkeywordtag 	plädierte 	dafür , der `` fatalen Normen-Erosion '' und der `` Kriminalität im Nadelstreifen '' durch einen Selbstreinigungsprozeß zu begegnen . 
plaedieren_s10511_f1	Auf Journalistenfragen wollte erkeywordtag zwar nicht ausdrücklich für den Erhalt des kleinsten Bundeslandes 	plädieren 	, doch sagte er , zum Föderalismus gehöre das `` Nebeneinander von Großen und Kleinen '' . 
plaedieren_s10940_f1	Mit dem Abstimmungsergebnis erlitten die parteiinternen Gegner einer großen Koalition , diekeywordtag für den Gang in die Opposition 	plädiert 	hatten , eine vorläufige Niederlage . 
plaedieren_s12000_f1	Vor einem Wiederaufnahmeverfahren 	plädiert 	Erwin Leiser jetzt mit seinem Film für den einst zu Unrecht Angeklagten ( Egon-Erwin-Kisch-Preis für den besten publizistischen Beitrag ) . 
plaedieren_s14060_f1	Nun wollen wirkeywordtag hier keinen Abgesang auf die Kultur anstimmen , sondern im Gegenteil für etwas 	plädieren 	, wofür die Düsseldorfer Ausstellung - unter anderem - ihrerseits den Blick öffnen will : daß die Selbstverständlichkeiten eben dieses Blickes immer wieder revidiert gehören . 
plaedieren_s14926_f1	Wirkeywordtag 	plädieren 	für eine Ökonomie des Vermeidens durch die Qualifizierung von Arbeit und Bildung , innovationsorientierte Regulierung , eine umweltorientierte Steuerpolitik und die Einbindung sozialer und ökologischer Ziele in einzelwirtschaftliches Handeln . 
plaedieren_s17431_f1	David Bloch vom Terezin Music Memorial Project in Israel 	plädierte 	am vehementesten für eine neue Herangehensweise an die Werke der von den Nazis umgebrachten , insbesondere jüdischen Komponisten - gegen eine neue Gettoisierung . 
plaedieren_s17583_f1	Die SPD-Bundestagsabgeordneten um Richter , diekeywordtag im Oktober mit einem Thesenpapier `` Für eine souveräne SPD '' 	plädiert 	haben , wollen ihre Partei für ein künftiges Bündnis mit der PDS offenhalten - für die Zeit nach 1999 . 
plaedieren_s18092_f1	Wirkeywordtag 	plädieren 	für eine Ökonomie des Vermeidens durch die Qualifizierung von Arbeit und Bildung , innovationsorientierte Regulierung , eine umweltorientierte Steuerpolitik und die Einbindung sozialer und ökologischer Ziele in einzelwirtschaftliches Handeln . 
plaedieren_s19642_f1	`` Ichkeywordtag 	plädiere 	dafür , zum frühestmöglichen Zeitpunkt über dieses Signal konkret zu reden '' , sagt der Manager . 
plaedieren_s19947_f1	Daher 	plädiert 	der Beschäftigungsausschuß europaweit für den Kerngedanken der sozialen Marktwirtschaft . 
plaedieren_s19958_f1	Der Beschäftigungsausschuß 	plädiert 	für eine EU-Koordinierungspolitik mit dem Ziel einer allgemeinen Vereinheitlichung von Lohn- und Gehaltsstrukturen im Hinblick auf die Steuern und den selektiven Abbau der Beitragsbelastungen . 
plaedieren_s19987_f1	Fischerkeywordtag wehrt sich aber gegen den Anschein einer jegliche Orientierung verhindernden `` neuen Unübersichtlichkeit '' ( ein Ausdruck von Habermas ) , 	plädiert 	vielmehr für radikal veränderte Rasterungen und Bezugsfelder , die eine pluralistischen Musiksituation in der postmodernen Gegenwart adäquater erfassen und beschreiben könnten . 
plaedieren_s20208_f1	Sachsens SPD-Chef Kunckel 	plädiert 	für eine stärkere Auseinandersetzung mit der PDS 
plaedieren_s20516_f1	Siekeywordtag 	plädiert 	für die Autonomie der Ogoni , eine der rund 430 ethnischen Gemeinschaften im Vielvölkerstaat Nigeria , die etwa 550 000 Menschen zählt . 
plaedieren_s20607_f1	De Charette 	plädierte 	zudem für die Aufnahme ost- und mittelosteuropäischer Länder in die EU . 
plaedieren_s20800_f1	Der Schweizer Andreas Gross und der Bayer Thomas Mayer , der in seinem Bundesland gegen den Willen der CSU auf plebiszitärem Wege mehr Plebiszite in den Kommunen durchgesetzt hat , 	plädierten 	heftig für eine solche `` Anreicherung '' ( Limbach ) der parlamentarischen Demokratie . 
plaedieren_s21704_f1	Es ist kurios , wenn Philosophenkeywordtag für das Individuelle 	plädieren 	- und dann Strukturen verachten . 
plaedieren_s22470_f1	Der Pastor 	plädierte 	für die Umwandlung der Bundeswehr in eine Freiwilligen-Armee nach dem Vorbild anderer Länder . 
plaedieren_s22572_f1	Trotzdem 	plädieren 	viele NGO für eine Zusammenarbeit mit dem `` Staat '' - immer das `` russische Verständnis des Wortes '' vor Augen : 
plaedieren_s23163_f1	Das Institut 	plädiert 	für `` eine neue Form der Kooperation zwischen den wichtigsten wirtschaftspolitischen Akteuren ( Staat , Bundesbank , Tarifparteien ) , um arbeitsplatzgefährdende Konflikte zwischen der Geld- , Finanz- und Lohnpolitik zu vermeiden '' . 
plaedieren_s23773_f1	Kantherkeywordtag 	plädiert 	für besseren Zeugenschutz 
plaedieren_s24728_f1	Ich stimme völlig mit jenen überein , diekeywordtag für Versöhnung und Nachsicht unter allen 	plädieren 	, die die israelische Gesellschaft bilden . 
plaedieren_s25799_f1	Der UNHCR 	plädierte 	für ein Umdenken bei der Bewältigung von Krisen . 
plaedieren_s26056_f1	Mohssen Massarrat 	plädiert 	für Dritte Kammern 
plaedieren_s27168_f1	Staatsanwaltkeywordtag 	plädierte 	im UB-Plasma-Prozeß 
plaedieren_s27700_f1	Siekeywordtag 	plädiere 	vielmehr für die Vision einer `` Brücke ins Solarzeitalter '' . 
plaedieren_s27889_f1	Die lebensrettenden Stimmen müssen sich die Liberalen dann in dem Drittel der Bevölkerung holen , daskeywordtag bei der Ifo-Umfrage für längere Abendverkaufszeiten 	plädierte 	. 
plaedieren_s28934_f1	In seinem anspruchsvollen Versuch , eine Theologie zu formulieren , diekeywordtag auf absolute Wahrheiten verzichtet und für `` Kirche als Überzeugungsgemeinschaft '' 	plädiert 	, zeigte sich Eid erheblich näher an der modernen Debatte als Küng . 
plaedieren_s29672_f1	Die reisproduzierenden Länder Japan , China , Taiwan und Südkorea hatten für den Schutz ihrer Landwirtschaft 	plädiert 	. 
plaedieren_s30447_f1	In Rußland dagegen fordern nationalistische und altkommunistische Kräfte die Aufhebung der Flankenregel , während eine prowestliche hauptsächlich im Außenministerium angesiedelte Fraktion ... für einen Kompromiß mit den Nato-Staaten 	plädieren 	. 
plaedieren_s30699_f1	Der Mittelstandspräsident 	plädierte 	für einen `` Selbstreinigungsprozeß '' in der Wirtschaft . 
plaedieren_s32091_f1	Zwar weist Schillo darauf hin , das dieses `` an allen Schauplätzen des Massentourismus feststellbare Verhalten nicht abwertend beurteilt werden sollte '' , dessen ungeachtet aber 	plädiert 	der Planer im besten touristischen Hardliner-Jargon dafür , `` daß eine vielfältige Erlebnis- und Animationsumgebung im direkten Umfeld des Urlaubers geschaffen wird . '' 
plaedieren_s32204_f1	Mankeywordtag mag für den Wiederaufbau dieses revolutionären Bauwerks 	plädieren 	, aus ästhetischen genauso wie aus architekturhistorischen Gründen , aus städtebaulichen wie aus stadträumlichen , aus touristischen oder urbanen . 
plaedieren_s36155_f1	Westdeutsche Sozialdemokraten 	plädierten 	dafür , die SPD müsse ihr Verhältnis zur PDS neu bestimmen . 
plaedieren_s37475_f1	Als Vertreter der Aussteller 	plädierte 	der Präsident der Pariser Hermés-Gruppe , Jean-Louis Dumas , für eine stärkere Harmonisierung der europäischen Handelspolitik . 
plaedieren_s38479_f1	Der Vorstandssprecher der Deutschen Bank , Rolf-Ernst Breuer , 	plädiert 	dafür , im Rahmen der geplanten Aktienrechtsreform die Aufsichtsräte zu verkleinern . 
plaedieren_s38713_f1	Kunibert Raffer , Professor an der Uni Wien , 	plädiert 	engagiert für ein internationales Insolvenzrecht mit einem unabhängigen Gericht und `` Schadenersatzpflicht der Gläubiger bei grober Fahrlässigkeit '' , um `` allzu sorglose Kreditvergabe zu verhindern '' . 
