praesentieren_s2337_f1	Das Regierungsbündnis von Union und FDP 	präsentiere 	sich vielmehr `` ohne inneren Halt '' und werde nur noch von der Angst vor dem endgültigen Bruch getrieben . 
praesentieren_s2991_f1	Während das industrielle Breiten- und das Auslandsgeschäft sich in eher schwacher Verfassung 	präsentierten 	, profitierte Siemens von öffentlichen Infrastrukturprojekten insbesondere im Gefolge der deutschen Vereinigung , die den Sparten Verkehrs- , Automatisierung- und Nachrichtentechnik kräftig Arbeit bescherten . 
praesentieren_s3462_f1	Da trifft es sich gut , daß mankeywordtag eine vorzeigbare Figur aus dem Osten 	präsentieren 	kann , die nicht in die allgemeine `` Hexenjagd '' einfällt : 
praesentieren_s6114_f1	Auf dem Düsseldorfer Messegelände 	präsentieren 	bis Freitag 875 Aussteller aus 39 Ländern Angebote rund um den Arbeitsschutz . 
praesentieren_s6116_f1	Zu den Neuheiten gehört eine elektronische Promille-Wegfahrsperre für Berufskraftfahrer , diekeywordtag ein Hersteller aus Lübeck 	präsentiert 	. 
praesentieren_s6911_f1	Greenpeace bietet fernsehgängige Ereignisse , und die Medien können eine Nachricht als Kitzel 	präsentieren 	, eine Symbiose ganz im Stil der Postmoderne . 
praesentieren_s7259_f1	aber wie dieser quirlige und immer freundliche Festivalchef hinter den eingeladenen Filmen steht und wie erkeywordtag siekeywordtag persönlich 	präsentiert 	, das schafft eine Atmosphäre , in der sich alle - Filmemacher , Festivalmitarbeiter , Verleiher , Kritiker und das normale filminteressierte Hofer Publikum - als Teil einer `` Familie '' , fühlen können . 
praesentieren_s7262_f1	Badewitz ' alter Freund Wim Wenders , der für Hof vor Jahren den Beinamen `` Home of Films '' erfand , 	präsentierte 	diesmal die deutsche Erstaufführung seines mit und für Antonioni inszenierten Films Jenseits der Wolken - das Road Movie als Episodenfilm , der Episodenfilm als Road Movie . 
praesentieren_s7266_f1	Josef Rödls Albert - warum ? wurde hier 1978 enthusiatisch gefeiert , Dominik Graf 	präsentierte 	1982 seine Spieler , 1984 landete Xaver Schwarzenberger mit Donauwalzer einen Hit . 
praesentieren_s7824_f1	Walesa kommentierte die Wahl nach Bekanntgabe der ersten Hochrechnungen , diekeywordtag zunächst ihn und nicht Kwasniewski als knappen Sieger 	präsentierten 	. 
praesentieren_s7957_f1	Offenbar möchte das Postministerium die Einigung nach der nächsten interfraktionellen Verhandlungsrunde am Mittwoch der Öffentlichkeit 	präsentieren 	. 
praesentieren_s8218_f1	In `` Korb II '' 	präsentiert 	der Saarländer seine Lieblingsidee von der `` Ökologischen Steuerreform '' . 
praesentieren_s8330_f1	Die Bundesrepublik werde sichkeywordtag auf der brasilianischen Technologieausstellung Febral vom 27. November bis 3. Dezember in São Paulo dem `` gemeinsamen Markt des Südens '' 	präsentieren 	, sagte Wirtschaftsminister Günter Rexrodt . 
praesentieren_s8627_f1	Der UN-Sonderbeauftragte Gaspar Biro 	präsentierte 	der UN-Vollversammlung in New York einen Bericht , in dem er Regierung und paramilitärische Organisationen beschuldigt , Menschen zu versklaven , zu unterdrücken und brutal zu mißhandeln . 
praesentieren_s9188_f1	Zwei Stunden nach dem schrecklichen Ereignis hob siekeywordtag eine anarchistische Zelle aus , um der konsternierten Nation deren Mitglieder als Urheber des Terroraktes zu präsentieren . 
praesentieren_s9213_f1	Jüngst zu einer Ausstellung nach Bergamo eingeladen , bestand erkeywordtag darauf , eine satirische Hommage an den Medienzar und Fußballclubbesitzer Silvio Berlusconi zu präsentieren . 
praesentieren_s9443_f1	Ein `` search committee '' , dem unter anderem die Leiterin des örtlichen Goethe-Instituts angehörte , 	präsentierte 	dem Vorstand des Freundeskreises Kandidatenkeywordtag . 
praesentieren_s9498_f1	Wenn den ruhenden Killerzellen im Körper aber mit dem Gen-Mix nun Interleukin 2 und die Krebszellen zusammen 	präsentiert 	werden , so hat sich im Tierversuch gezeigt , reißen diese beiden Wecksignale die Killerzellen aus ihrem Dornröschenschlaf und töten die Krebszellen effektiv ab . 
praesentieren_s9743_f1	Staatliche Hilfen hingen davon ab , ob Dasakeywordtag eine überzeugende Zukunftsperspektive für Fokker 	präsentieren 	könne , hatte Minister Wijers mehrmals betont und eine erste Vorlage der Daimler-Tochter im September als `` ungenügend '' zurückgewiesen . 
praesentieren_s10466_f1	Eine Woche nach der vorgezogenen Neuwahl in Kroatien 	präsentierte 	Präsident Franjo Tudjman am Dienstag das neue Kabinett . 
praesentieren_s11511_f1	Indem siekeywordtag sich salonfähigkeywordtag 	präsentiere 	, erklärt ein Mitarbeiter vom Fonds zur Erforschung der gesellschaftlichen Meinung die guten Umfrageergebnisse , sei die KPRF heute auch für `` nichtkommunistische Unzufriedene '' wählbar . 
praesentieren_s11790_f1	Bürgermeister Helmut Schache gab im kleinen Saal in der unterdessen zur Reha-Klinik umfunktionierten Korps-Kultstätte `` Mutiger Ritter '' einen Empfang , auf der nahe gelegenen Rudelsburg 	präsentierte 	mankeywordtag zudem eine Ausstellung in eigener Sache , die die Geschichte des Verbandes aufarbeiten und `` verdeutlichen soll , daß Vorwürfe zur Rechtslastigkeit der Vereinigung unangemessen sind '' , wie Rüdiger-Arnd Spingorum meint . 
praesentieren_s11925_f1	Die Führungsleistung des Präsidiums könne sich also selten so 	präsentieren 	, daß sie als einheitlich und geschlossen wahrgenommen wird . 
praesentieren_s12615_f1	Als Leimrute 	präsentierten 	siekeywordtag den 299 anwesenden Delegierten einen eigentlich von vornherein viel zu langen , geschwätzigen Leitantrag über SPD an sich , garniert mit ein paar provisorischen Forderungen , was man bei Koalitionsverhandlungen mit den Christdemokraten alles durchsetzen wolle , könne , müsse , solle . 
praesentieren_s12628_f1	Sichkeywordtag als `` Berlin-Partei '' gegenüber der `` Hauptstadt-Partei '' CDU zu präsentieren , wäre ein vor den Füßen der Partei liegendes unbesetztes Polit-Feld . 
praesentieren_s14684_f1	Dort erwarteten ihn Beamte des Staatsschutzkommissariates der Polizeidirektion Heidelberg und 	präsentierten 	ihmkeywordtag den am gleichen Tag ausgestellten Haftbefehl . 
praesentieren_s14994_f1	Mankeywordtag habe sich für die `` sozialverträgliche Variante '' , um Kleinanlegernkeywordtag später nicht eine höhere Rechnung 	präsentieren 	zu müssen , entschieden und gebe eine größere Zahl von Aktien aus . 
praesentieren_s17011_f1	Als herausragendes Beispiel 	präsentiert 	Peter Michel ein Super-Schnupper-Ski-Wochenende mit verbilligter Unterkunft , Liftpaß zum halben Preis und kostenlosen Leihskiern , das Anfang Dezember in 20 Schweizer Orten angeboten wird . 
praesentieren_s19743_f1	Der Sprecher des Weißen Hauses , Michael McCurry , sagte , die USA wollten nun wissen , `` welche neuen Kandidaten sichkeywordtag 	präsentieren 	werden '' . 
praesentieren_s20754_f1	Wertgutachten , Expertisen zur Situation auf den lokalen Märkten oder gar Namen potentieller Erwerber konnte erkeywordtag nicht 	präsentieren 	. 
praesentieren_s22013_f1	`` Einfallsreichkeywordtag 	präsentierte 	sichkeywordtag auch der gastgebende Landesverband Sachsen-Anhalt : 
praesentieren_s23934_f1	Hajo Jahn beschloß die Tagung mit einem werbenden Vortrag über ein zukünftiges `` Centrum für verfolgte deutschsprachige Dichterinnen und Dichter '' , das als Begegnungs- und Forschungsstätte für die Auseinandersetzung mit dem Schicksal der deutschen exilierten Dichter und Künstler gedacht ist und in dem die Bücher , die während des Nationalsozialismus verboten und verbrannt wurden , der deutschen Öffentlichkeit 	präsentiert 	werden sollen . 
praesentieren_s24519_f1	Und das dafür wesentlich verantwortliche Europäische Währungsinstitut ( EWI ) , daskeywordtag nun sein Szenario für den Übergang zum gemeinsamen Geld 	präsentierte 	, tut gut daran , Störmanöver zwar zur Kenntnis zu nehmen , aber sich davon nicht übermäßig beeindrucken zu lassen . 
praesentieren_s24533_f1	Was den technischen und zeitlichen Ablauf selbst angeht , hat Lamfalussykeywordtag ein `` Szenario furioso '' 	präsentiert 	. 
praesentieren_s25344_f1	Hier 	präsentiert 	sichkeywordtag eine SPD , die ganz anders ist als sie von Berichterstattern im Bonner Regierungs- und Presseviertel wahrgenommen werden kann . 
praesentieren_s25438_f1	Am gleichen Tag , als Unicef die neue Studie vorstellte , 	präsentierte 	die Schirmherrin des Kinderhilfswerks der UN in Deutschland , Christiane Herzog , in Berlin die neue Unicef-Grußkarte mit Motiven des Nürnberger Christkindl-Marktes . 
praesentieren_s26673_f1	sogar die Telefongespräche mit Gould ( dieser wurde immer menschenscheuer , befriedigte seine vorzugsweise nächtlichen Kommunikationsbedürfnisse fast ausschließlich fernmündlich ) machte Jonathan Cott zu Geld ( auf deutsch als Buch jetzt bei Zweitausendeins ) , und der gediegene Musikschriftsteller Attila Csampai 	präsentiert 	soeben ( bei Schirmer / Mosel ) einen Gould-Prachtband . 
praesentieren_s27099_f1	In dieser Situation 	präsentiert 	sich Zeroualkeywordtag als Mann von Moral und Moderne , als Vertreter der Befreiungsideale von 1954 : 
praesentieren_s27538_f1	Tatsächlich 	präsentiert 	sich die gesamte Vorsorgegilde derzeit recht gesund . 
praesentieren_s28593_f1	So aber sei daskeywordtag als eine Betriebsvereinbarung 	präsentiert 	worden . 
praesentieren_s29584_f1	Kwasniewskis Sicherheitschef Jerzy Dziewulski 	präsentierte 	den Medien zudem eine Kassette , die beweisen soll , daß Walesas Wahlkampfchef Jerzy Gwizdz mit einem gesuchten Betrüger gearbeitet hat . 
praesentieren_s31625_f1	Und diekeywordtag 	präsentiert 	sich im Winter oftmals grau in grau . 
praesentieren_s31956_f1	Erstmals werden die Programme unter dem Motto `` Do it ! '' in separaten Länderbroschüren 	präsentiert 	. 
praesentieren_s33635_f1	Das Heft mit Darstellung der Rechtslage , von Beispielfällen und Musterbriefen wird voraussichtlich im Dezember erscheinen und dann in der FR 	präsentiert 	. 
praesentieren_s34026_f1	Lafontaine , derkeywordtag sichkeywordtag in seiner Schlußrede en passant ganz selbstverständlich als Kanzlerkandidat 	präsentiert 	hat , ist dem Machtkampf und damit dem Risiko einer ersten Niederlage ausgewichen . 
praesentieren_s37855_f1	Eurostat , das Statistische Amt der Europäischen Gemeinschaften in Luxemburg , hat zum ersten Mal nach einem einheitlichen System berechnet und dadurch vergleichbare Inflationszahlen für die 15 Staaten der Union 	präsentiert 	. 
