produzieren_s1569_f1	Deutsche Industrie 	produziert 	weniger 
produzieren_s2266_f1	Zu DDR-Zeiten wurden dortkeywordtag hauptsächlich Röntgenfilmekeywordtag 	produziert 	. 
produzieren_s3445_f1	Zwar 	produziere 	dieseskeywordtag derzeit nur Fertigteile für den Wirtschafts- und Wohnungsbau , die alten Anlagen zur Produktion von Betonschwellen seien aber noch vorhanden . 
produzieren_s3584_f1	Bei gleichbleibender Lage könne nur noch zwei Tage 	produziert 	werden , hieß es . 
produzieren_s3585_f1	Ford in Belgien meldete , daß Teile , diekeywordtag in Spanien , Portugal und Frankreich 	produziert 	würden , auf Frankreichs Straßen hängengeblieben seien . 
produzieren_s5660_f1	Die Industrie brauche aber politischen Druck , um umweltfreundlicher zu produzieren . 
produzieren_s5817_f1	Der langjährige Queen-Produzent Mack ( derkeywordtag auch die neue CD mit 	produziert 	hat ) nannte diese Art der Nachlaßverwaltung , bei der Kompositionen verändert und Textzeilen weggelassen wurden , eine `` widerliche Leichenfledderei und dilettantische Sauerei '' . 
produzieren_s7907_f2	In dem jüngst erschienenen Buch von Steven J. Bock und Michael Boyette wird das Hormon , daskeywordtag mit zunehmenden Alter in immer geringeren Mengen 	produziert 	wird , als wahrer Jungbrunnen , als `` Quelle von Jugend und Gesundheit '' gepriesen . 
produzieren_s8248_f1	Da der Markt allein keine Gerechtigkeit 	produziere 	, müßten Christen in Partnerschaft mit anderen sozialen Gruppen auf einen `` Sozialpakt für Arbeit und sozialen Frieden '' dringen , mahnte Brakelmann . 
produzieren_s8540_f1	Tatsächlich 	produzieren 	siekeywordtag allzuleicht neue Ungerechtigkeitenkeywordtag . 
produzieren_s10818_f1	Die Fernsehgesellschaft Turner Network Television ( TNT ) hat den Film , der Teil einer Serie über führende Indianer der Geschichte ist , bereits 	produziert 	. 
produzieren_s11209_f1	Wenn die Eurowährung Anfang 1999 plangemäß aus der Taufe gehoben werde , dürfte es noch zweieinhalb bis drei Jahre dauern , bis die Banknoten 	produziert 	sind . 
produzieren_s12298_f1	Ein Quertreiber wie Gellner - voller Humescher Sympathien , aber auch mit `` Prager Hinter- und Widersinn '' - 	produziert 	weder Gefolgschaft noch schulbildende oder berufungsrelevante Sprachregelungen . 
produzieren_s13734_f1	Das Unternehmen 	produzierte 	einschließlich Fremdfertigung mehr als 20 000 Fahrzeuge . 
produzieren_s14155_f1	Hungarovin und BB 	produzieren 	vorwiegend für ihren heimischen Markt . 
produzieren_s14310_f2	Nicht alle Gerechtigkeits-Maßnahmen konnten also auch ihre musikalische Rechtfertigung 	produzieren 	. 
produzieren_s17162_f1	In Indien und woanders wird billiger 	produziert 	als bei uns , aber nicht unbedingt schlechtere Produkte . '' 
produzieren_s17890_f1	Nach literarischen Vorlagen des seit Ende der 40er Jahre in Tanger lebenden Schriftstellers haben Schlaich und seine Kollegin Irene von Alberti drei eigenständige Kurzfilme 	produziert 	: Am Strand von Merkala , Zwischenhalt in Corazon sowie Allal . 
produzieren_s18171_f1	- Die Rahmenbedingungen für Investitionen in zukünftigen Schlüsselbranchen wie beispielsweise die Bio- und Gentechnologie müssen so gestaltet sein , daß die Unternehmen hier ohne Wettbewerbsnachteile forschen , entwickeln und 	produzieren 	können . 
produzieren_s19886_f1	Preissteigerungen sind in der Exportwirtschaft aufgrund des härter gewordenen Wettbewerbs und der Billiglohnländer , diekeywordtag innerhalb der Europäischen Union und vor der Haustür der EU in Mittel- und Osteuropa 	produzieren 	, kaum noch möglich . 
produzieren_s20200_f1	Zudem sollen künftig auch Zölle von 30 bis 40 Prozent auf Importe von hochwertigen Ausrüstungen erhoben werden , diekeywordtag nicht in China 	produziert 	werden können . 
produzieren_s21743_f1	Der BMW-Ableger , der Teile importiert und dann im Werk in Toluca nahe Mexiko-Stadt montiert , 	produziert 	dieses Jahr 500 Wagen und strebt 1200 für 1996 an . 
produzieren_s21932_f2	Sonnenkollektoren auf dem Dach 	produzieren 	warmes Wasser , das auch für die Fußbodenheizung genutzt wird . 
produzieren_s22496_f1	Die inzwischen 265 Chemiefirmen in Ostdeutschland allein 	produzierten 	dagegen bis Ende September rund 35 Prozent mehr als im Vorjahr . 
produzieren_s23134_f1	Diekeywordtag dürfen selbst ( fast ) keinen Strom 	produzieren 	, sondern beziehen ihn von einem `` Pool '' . 
produzieren_s23290_f1	Die US-amerikanische Filmfirma Carolco , diekeywordtag einige der bekanntesten Kinoerfolge von Sylvester Stallone ( Rambo ) und Arnold Schwarzenegger ( Terminator 2 und Total recall ) 	produzierte 	, ist am Ende . 
produzieren_s24091_f1	Siekeywordtag kaufen ihre Software lieber in Indien ein , statt siekeywordtag selbst zu produzieren . 
produzieren_s25081_f1	Richtig , Chinas Volksbefreiungsarmee hat sich seit Beginn der Wirtschaftsreformen Deng Xiaopings ein Wirtschaftsimperium aufgebaut , daskeywordtag Eiscreme und Autos 	produziert 	, Karaoke-Bars und Fluglinien managt , Waffen und Lebensmittel im Ausland verkauft . 
produzieren_s26624_f1	Doch keineswegs alles , waskeywordtag Gouldkeywordtag dann 	produzierte 	, hatte einen ähnlich sensationellen Aplomb . 
produzieren_s26931_f1	Mit Outsourcing und der Schließung von Teilen der Fertigung wollte der Anlagenbauer KHS 1993 kostengünstiger 	produzieren 	. 
produzieren_s27728_f3	Melatonin ist ein körpereigenes Hormon , daskeywordtag in der Zirbeldrüse , aber auch im Darm 	produziert 	wird . 
produzieren_s27748_f3	, Wer weniger ißt , 	produziert 	mehr Melatonin und bleibt länger gesund '' , meint der Göttinger Experte . 
produzieren_s28756_f2	Anders als in der Vergangenheit , als in der LPG Wilhelm Pieck 6000 Jungrinder riesige Gülleüberschüsse 	produzierten 	- Vechta läßt grüßen - , stimmt heute die Anzahl der Tiere mit der Größe der Fläche überein . 
produzieren_s28969_f2	Bürgermeister Franz-Joseph Winterhalter argumentiert wie Axel Mayer vom südwestdeutschen Bund für Umwelt und Naturschutz : Windräderkeywordtag 	produzieren 	keine Schadstoffe , sind sauberer als Atom- oder Kohlekraftwerke . 
produzieren_s29395_f1	Dies wurde besonders bei dem von ihm in die Wege geleiteten `` Großen Sprung nach vorn '' deutlich , der bekanntlich in einem ökonomischen Desaster endete , weil die `` Schöpferkraft der Massen '' an Mittel gebunden ist , die es aber damals kaum gab , daher von ihnen erzeugt werden sollten , ebenso wie an die Arbeitskraft selbst , diekeywordtag nicht gleichzeitig Stahlkeywordtag 	produzieren 	und Agrikultur betreiben kann . 
produzieren_s29402_f2	Es ist aufschlußreich für den Maßstab , den Deng an Produktivität anlegt , wenn er die ökonomische Binsenweisheit , daß die Arbeitskraft mehr zu produzieren in der Lage ist als sie zu ihrer eigenen Reproduktion benötigt , in ihr Gegenteil umkehrt : 
produzieren_s29441_f1	Die Parteiführung beschloß , ausgewählte Experimentierfelder - Sonderwirtschaftszonen ( SWZ ) - einzurichten , in denen ausländisches Kapital zu günstigen Konditionen für den Export 	produzieren 	und über die chinesische Beteiligung Devisen erwirtschaften sollte . 
produzieren_s29898_f1	Momentan sei die Industrie aber noch nicht in der Lage , leistungsfähige digitale Hörgeräte im Kleinstformat zu produzieren , sagte Kollmeier . 
produzieren_s30137_f1	Ivaxkeywordtag 	produziert 	vorwiegend preiswerte Kopien von Markenprodukten , deren Patente abgelaufen sind . 
produzieren_s31581_f1	Mit Sorge beobachtete sie das Vordringen von denaturierten Lebensmitteln in ein Tal , in dem fast alles noch am Ort erzeugt wird oder wie einst wieder 	produziert 	werden könnte . 
produzieren_s33858_f1	Seine 22 Bücher schrieb er in weniger als zehn Jahren , ein disziplinierter `` Macher '' , derkeywordtag nicht nur als Präsident des nigerianischen Schriftstellerverbandes diesen erst richtig funktionsfähig werden ließ , sondern die eigenen Bücher im eigenen Verlag verlegte und auch die populären Fernsehserien , die `` die Straßen von Lagos leerfegten '' , selbst 	produzierte 	: Basi and Company . 
produzieren_s34528_f1	In Ho-Chi-Minh-Stadt ( früher Saigon ) hatte Kohl zuvor den Grundstein für ein deutsch-vietnamesisches Automobilwerk gelegt , in dem von 1996 an Mercedes- Fahrzeuge 	produziert 	werden sollen . 
produzieren_s34779_f1	Zur Not müssen eben immer mehr Straßen gebaut , immer mehr Waffen 	produziert 	, Menschen flexibilisiert , Sozial- und Umweltstandards auf Weltniveau heruntergebracht und staatliche Subventionen in die Höhe geschraubt werden , um die Konkurrenzfähigkeit der deutschen Wirtschaft zu sichern . 
produzieren_s34811_f1	Schließlich : Dauerhafte Exportüberschüsse sind weder hinsichtlich der Wohlfahrt ( national kann dann ja weniger konsumiert als 	produziert 	werden ) noch hinsichtlich der Arbeitsplatzssicherung von Vorteil ( weil damit oft einhergehende Kapitalexporte und Währungsaufwertungen Produktionsverlagerungen ins Ausland bewirken können ) . 
produzieren_s34820_f1	Moderne sozialdemokratische Wirtschaftspolitik darf und braucht sich auf keinen neuen , diesmal globalen Manchesterkapitalismus einlassen , in dem sich nationale Arbeitnehmerschaften gegenseitig die Arbeit wegnehmen , in dem ohne Rücksicht auf Bürgerkriege , Umweltkatastrophen und kulturellen Verfall 	produziert 	und gearbeitet , investiert und konsumiert wird . 
produzieren_s36838_f1	Inzwischen 	produzieren 	180 Angestellte rund vier Millionen Schmuckstücke pro Jahr in mehr als 3000 Variationen . 
produzieren_s37414_f1	Dies gelte sowohl für den Materialfluß von und nach Spanien als auch für die Belieferung der Märkte mit dem Kleinwagen Ka , denkeywordtag die spanische Schwester 	produziert 	. 
produzieren_s38812_f1	Die GmbH ging aus dem Mansfeld-Kombinat hervor und 	produziert 	mit 1400 Leuten Halbzeuge und Drähte . 
produzieren_s39283_f1	Dort , wokeywordtag die von der Motorpresse mit Vorschußlorbeeren überschüttete A-Klasse 	produziert 	wird - die Auslieferung beginnt im Herbst - gehört der Samstag künftig zur Regelarbeitszeit . 
