profitieren_s92_f1	Der zweite Punkt ist die Kürzung der Subventionen , die mehr als ein Zehntel der Staatsausgaben verschlingen , und von denen nicht etwa die Ärmsten der Armen 	profitieren 	. 
profitieren_s2991_f1	Während das industrielle Breiten- und das Auslandsgeschäft sich in eher schwacher Verfassung präsentierten , 	profitierte 	Siemenskeywordtag von öffentlichen Infrastrukturprojekten insbesondere im Gefolge der deutschen Vereinigung , die den Sparten Verkehrs- , Automatisierung- und Nachrichtentechnik kräftig Arbeit bescherten . 
profitieren_s3071_f1	Diese Erfahrung muß zumindest die Bausparkasse Wüstenrot machen , diekeywordtag - wie die gesamte Branche - seit der Währungsunion enorm von den neuen Ländern 	profitiert 	hat . 
profitieren_s3421_f1	Zudem 	profitieren 	die Essener vom Image der `` umweltfreundlichen und sauberen '' Verbrennung ihrer Energie . 
profitieren_s6026_f1	Dort versuchen Schmugglerkeywordtag immer häufiger , von erheblichen Preisunterschieden zu profitieren . 
profitieren_s6551_f1	Von der schwarzen Kasse sollen neben Präsident Kim Young Sam auch die beiden wichtigsten Oppositionsführer Südkoreas , Kim Dae Jong und Kim Jong Pil , 	profitiert 	haben . 
profitieren_s7407_f1	Zum einen hatte es die SPD versäumt , das rein machtpolitische Verhältnis der CDU zur PDS zum Wahlkampfthema zu machen , zum anderen 	profitierte 	die CDU auch davon , daß die SPD keine klare Koalitionsaussage machte , kein rot-grünes Reformprojekt vorlegte und insgesamt auch nicht überzeugend vermitteln konnte , daß sie durchsetzungsfähig ist . 
profitieren_s9149_f1	Der hiesige Markt , so hieß es im Handel weiter , habe auch von der Aufwärtsbewegung an der Pariser Börse nach der Ankündigung der Kabinettsumbildung in Frankreich 	profitiert 	. 
profitieren_s9520_f1	Andererseits sagst Du mir , daß ich immer nur hinterhergelaufen bin , daß ich von Euren Giften koste und Euch das Blut aussauge , Euch , die Ihr die wahren Experimentatoren und Helden seid , während ichkeywordtag nur am Rand stehe , zuschaue und von Euch 	profitiere 	. 
profitieren_s9570_f1	Also gehe ich zu Deinem nächsten Kritikpunkt über , nämlich daß ichkeywordtag immer im Schlepptau gewesen bin , mich nicht wirklich verausgabt , von den Experimenten der anderen 	profitiert 	habe , Schwulen , Junkies , Alkoholikern , Masochisten , Verrückten ... etc. , ihre Freuden und Gifte ein wenig gekostet habe , ohne je irgend etwas zu riskieren . 
profitieren_s9965_f1	Vom Gewinnwachstum sollen zwar die Aktionäre 	profitieren 	, nicht aber die Beschäftigten . 
profitieren_s10261_f1	Im übrigen 	profitierten 	die Unternehmen von dem verstärkten ökologischen Bewußtsein durch zusätzliche Aufträge . 
profitieren_s10477_f1	Von ihrem Opfer 	profitieren 	die Nichtverkäufer . 
profitieren_s13046_f1	Daß Arbeitsplätze wegfallen , Einzelhändler das Nachsehen haben , lediglich riesige Kaufzentren auf der grünen Wiese 	profitieren 	würden , die Situation der betroffenen Verkäufer sich verschlechtern würde und die meisten Kunden mit der geltenden Regelung zufrieden sind : Diese und andere Argumente kamen zur Freude der Kompromiß-Gegner offenbar ziemlich gut an . 
profitieren_s13092_f1	Daß Arbeitsplätze wegfallen , Einzelhändler das Nachsehen haben , lediglich riesige Kaufzentren auf der grünen Wiese 	profitieren 	würden , die Situation der betroffenen Verkäufer sich zu verschlechtern droht und die meisten Kunden mit der geltenden Regelung zufrieden sind : Diese und andere Argumente kamen zur Freude der Gegner des Kompromisses offenbar ziemlich gut an . 
profitieren_s14794_f1	Befördert wird das kreative Chaos , weil die verschiedenen Gruppen , die Kontakte zu europäischen Institutionen suchen , das Ziel ihrer Lobbyarbeit als doppeltes beschreiben : für sich , aber auch für all jene , die keine Vertretung in Brüssel und Straßburg haben : die Armen , die Alten und alle , diekeywordtag nicht vom Wirtschaftsboom des gemeinsamen Marktes 	profitieren 	. 
profitieren_s15589_f1	Blüht der beschworene Wettbewerb auf , können auch Privatkunden 	profitieren 	. 
profitieren_s15981_f1	Nach Vorstellungen des Verbandes sollten wie früher wieder 70 und mehr Prozent der Bevölkerung und nicht wie derzeit nur rund 40 Prozent von Sozialwohnungen 	profitieren 	können . 
profitieren_s16264_f1	Bei verlängerten Öffnungszeiten würden nur Läden in Innenstädten und auf der grünen Wiese 	profitieren 	. 
profitieren_s19218_f1	Noch vermochte die FDP vom Streit um die Diäten nicht zu profitieren . 
profitieren_s19919_f1	- Zur Wettbewerbsgerechtigkeit ist sicherzustellen , daß Betriebe , diekeywordtag nicht ausbilden , aber von qualifizierten Arbeitnehmern 	profitieren 	, an den beruflichen Bildungskosten beteiligt werden . 
profitieren_s20161_f1	Es ist für die Algerier , die auf Abwege gekommen sind , möglich , sich aufzufangen und von den strafmildernden Maßnahmen zu profitieren , welche der Staat für sie beschlossen hat . 
profitieren_s20230_f1	Die zehn Prozent , die 1990 PDS wählten , waren Leute , diekeywordtag vom SED-System 	profitiert 	hatten . 
profitieren_s20324_f1	China wird ein immer wichtigerer Wirtschaftspartner der Bundesrepublik , und davonkeywordtag wird die Bevölkerung beider Länder 	profitieren 	. 
profitieren_s20364_f1	Nach Darstellung der GfBV werden hiervonkeywordtag diejenigen 	profitieren 	, die illegal in diese Gebiete eingedrungen sind . 
profitieren_s20403_f1	Arbeitgeber , diekeywordtag von der billigen Arbeitskraft illegaler Ausländer 	profitierten 	, müßten bei Aufdeckung außer den Bußgeldern auch den Betroffenen eine Art Abfindung zahlen , forderte er . 
profitieren_s23597_f1	Trumpfkeywordtag 	profitierte 	im Geschäftsjahr zum 30. Juni vom Branchenaufschwung . 
profitieren_s24238_f1	Auch Türkesch dürfte von dem Wahlbündnis 	profitieren 	- auf sich allein gestellt könnte seine MHP an der Zehnprozenthürde scheitern . 
profitieren_s26528_f1	wem die Umstellung auf neue Werte , auf neue Arbeitsformen gelingt , derkeywordtag könne auch davonkeywordtag 	profitieren 	. 
profitieren_s29046_f1	Wirtschaftlich 	profitiert 	eskeywordtag erheblich von der EU . 
profitieren_s29060_f1	Wenn Luxemburgkeywordtag von den Fehlern deutscher Finanzpolitik 	profitiere 	, sei das doch Sache der Deutschen . 
profitieren_s29705_f1	Leider haben davonkeywordtag die Anlageinvestitionen nicht 	profitiert 	. 
profitieren_s29799_f1	Das schreibt die Firma Utimaco Safeware , diekeywordtag davonkeywordtag auch per Ende Juni im Geschäftsjahr 1994 / 95 	profitierte 	. 
profitieren_s29851_f1	Im Gegenteil dürften die Lebens- oder Rentenversicherten nach Meinung des Gesamtverbandes der Deutschen Versicherungswirtschaft ( GDV ) von dem Eurogeld 	profitieren 	. 
profitieren_s29962_f1	Die Aktionäre sollen von dieser Entwicklung 	profitieren 	. 
profitieren_s31404_f1	Burns unterstrich , damit könne das Land von diesen Organisationen auch nicht 	profitieren 	. 
profitieren_s32113_f1	Etwa durch das Aufkommen von sauerstoffproduzierenden Bakterien vor Jahrmilliarden , von deren `` altruistischem '' Wirken wirkeywordtag bis heute 	profitieren 	. 
profitieren_s33041_f1	Geschichtsklitterung zu betreiben , mag dort erlaubt sein , wo die erzählte Geschichte von ihrer Klitterung 	profitiert 	. 
profitieren_s33042_f1	Werkeywordtag aber 	profitiert 	, wenn die Eroberung des nordamerikanischen Kontinents nicht als kolossales Metzgerhandwerk , sondern als multikulturelles Liebesinteresse daherkommt , steht auf einem anderen Blatt . 
profitieren_s33945_f1	Safranski sagt , sein Buch habe `` das Interesse an Heidegger insgesamt wieder so geweckt ... , daß Ettingers Buch davonkeywordtag nur 	profitieren 	kann '' . 
profitieren_s34405_f1	Der US-Computerkonzern Hewlett-Packard ( HP ) hat von der starken Nachfrage nach Personalcomputern vor allem in den USA und Deutschland 	profitiert 	. 
profitieren_s35912_f1	Die Bundesregierung halte auch weiter an ihrer Forderung fest , mit 30 Prozent von der Herstellung des `` Eurofighters '' zu profitieren . 
profitieren_s37279_f1	Diesekeywordtag 	profitiert 	andererseits von der Verpachtung der elf in einer Immobilienfirma gebündelten Hotels an das Unternehmen . 
profitieren_s37341_f1	die übrigen Staaten könnten nach den klassischen Gatt-Regeln von der Meistbegünstigungsklausel 	profitieren 	. 
profitieren_s37788_f1	Vom Wachstum 	profitieren 	nur kleine Gruppen der Bevölkerung , Umverteilungsbemühungen sind dort , wo sie überhaupt versucht wurden , gescheitert . 
profitieren_s38708_f1	Diese Programme seien `` höchst umstritten '' , vielfach hätten die Armen davonkeywordtag `` nicht 	profitiert 	'' . 
profitieren_s39566_f1	Mehr noch als die heimischen Anbieter 	profitieren 	Importeurekeywordtag von der zunehmenden Lust aufs Geflügelschnitzel . 
profitieren_s39649_f1	Die Aktionäre des einst staatlichen Bonner Konzerns 	profitieren 	zum achten Mal in Folge mit einer Dividendenerhöhung . 
