protestieren_s571_f1	Die Schatzmeister der beiden Parteien 	protestierten 	dagegenkeywordtag und kündigten juristische Schritte an . 
protestieren_s1332_f0	Die Lkw-Fahrer 	protestieren 	seit knapp einer Woche gegen die Einführung eines Strafpunktesystems nach dem Muster des Flensburger Registers . 
protestieren_s1451_f0	In London haben am Wochenende mehrere hundert Menschen dagegen 	protestiert 	, daß der umstrittene Historiker David Irving mit der Abschrift der kürzlich entdeckten Tagebücher des NS-Propagandaministers Joseph Goebbels beauftragt wurde . 
protestieren_s1610_f2	Frauen vom Land kämpften aktiv darum , ein Staudammprojekt zu verhindern oder 	protestierten 	gegen die Abholzung der Wälder . 
protestieren_s1672_f0	Siekeywordtag wollen 	protestieren 	gegen diese Landesregierung in Potsdam : 
protestieren_s1777_f0	Unter dem Motto `` 500 Jahre Kolonialismus sind 500 Jahre zuviel '' haben am Samstag in München rund 15 000 Demonstranten aus ganz Deutschland gegen den westlichen Wirtschaftsgipfel 	protestiert 	, der am heutigen Montag in der bayerischen Landeshauptstadt beginnt . 
protestieren_s2068_f0	Viele Atomkraftgegner 	protestierten 	am Fabriktor dagegen , daß Japan , trotz eines gegenläufigen Trends in der Welt , Plutonium für die Weiterentwicklung seines schnellen Brüters `` Monju '' verwendet . 
protestieren_s2245_f1	Die rund 8000 Zollbeamten Portugals haben am Montag eine Streikwoche bis zum Samstag um Mitternacht begonnen , mit der siekeywordtag gegen den Verlust ihrer Arbeitsplätze nach Abschaffung der Binnengrenzen in der EG ab 1993 	protestieren 	wollen . 
protestieren_s3314_f0	Dann wa waren Motorradfahrer eingetroffen , diekeywordtag wie sie gegen den neuen Führerschein nach Punkten 	protestieren 	. 
protestieren_s3985_f0	Nach neun Tagen Straßenblockaden , mit denen die französischen Lastwagenfahrer im ganzen Land gegen ein neues Strafpunktesystem für Verkehrsverstöße 	protestiert 	haben , zeichnete sich am Dienstag die Aussicht auf ein Ende des Konflikts ab . 
protestieren_s4225_f1	Saro-Wiwakeywordtag hat gegen die Zerstörung der Umwelt im Nigerdelta und der Lebensräume des Ogoni-Stammes durch die Ölgewinnung internationaler Konzerne 	protestiert 	. 
protestieren_s6807_f2	Indianerkeywordtag 	protestieren 	gegen Fallenfang-Verordnung der EU / 
protestieren_s10770_f0	Studentenkeywordtag 	protestierten 	gegen Bafög-Verzinsung 
protestieren_s11307_f0	Im Lauf : Wie jene Bauern im Hunsrück , diekeywordtag mit wehenden Fahnen gegen den Fluglärm der Jagdbomber 	protestieren 	und die aussehen , als hätte sie eine Zeitmaschine aus den Bauernkriegen ins zwanzigste Jahrhundert geschleudert . 
protestieren_s11761_f2	`` Diese Leute hier mit großem Bahnhof zu empfangen '' , 	protestierte 	Stadtrat Peter Jeschke beim Bürgermeister , `` setzt ein falsches Signal . '' 
protestieren_s14125_f2	Die MDS-Partei wagte es nicht , gegen die Verhaftung zu protestieren und hoffte lediglich auf einen `` fairen Prozeß '' . 
protestieren_s15383_f1	Und es gibt ein Opfer : Ken Saro-Wiwa , derkeywordtag als Vorsitzender der `` Bewegung für das Überleben des Ogoni-Volkes '' ( Mosop ) gegen die rücksichtslose Ölförderung 	protestiert 	hatte , die seiner Heimatregion leuchtende Gasfeuer , leckende Pipelines , katastrophale Umweltschäden und den Ogoni Krankheiten und den Tod gebracht hat . 
protestieren_s15416_f1	So 	protestierten 	denn auch im Fall Saro-Wiwa wieder vornehmlich die Schriftsteller . 
protestieren_s15480_f0	Auf Transparenten 	protestierten 	die Demonstranten gegen einen `` Abbau der Weltorganisation durch Budgetkürzungen '' . 
protestieren_s18012_f1	Seit Jahren 	protestieren 	die Ogoni , ein rund 500 000 Menschen zählender Volksstamm im Delta des Niger-Flusses , gegen die teils fahrlässige Erdölförderung , die ihr Land in ein ökologisches Notstandsgebiet verwandelt hat . 
protestieren_s21376_f0	Während der Rektorentagung 	protestierten 	rund 1000 Studenten . 
protestieren_s23185_f3	Gegen das Verbot der Demonstration `` Für eine politische Lösung in Kurdistan '' in Köln hat die Frankfurter Menschenrechtsorganisation medico international am Montag 	protestiert 	. 
protestieren_s25755_f2	Unescokeywordtag 	protestiert 	- Shell investiert 
protestieren_s27610_f2	Diekeywordtag kommen aus den altmodischen `` lebendigen Ortsvereinen '' und 	protestieren 	gegen die virtuelle Konkurrenz . 
protestieren_s28654_f3	Damit das Problem von allen Seiten beleuchtet ist , erscheint auch noch das Volk in Form einer hysterischen Frau und eines naseweisen Knaben und 	protestiert 	gegen die Verteuerung der Brotpreise . 
protestieren_s31109_f0	Niederländische Wehrpflichtige haben in Amsterdam einen `` nationalen Tag der Langeweile '' organisiert , um gegen die Sinnlosigkeit ihres Dienstes zu protestieren . 
protestieren_s31177_f2	Zuletzt war der frühere Präsident des West-PEN , Heidenreich , in den ostdeutschen Club eingetreten , womit erkeywordtag indirekt gegen die härtere Linie seiner Nachfolgerin Ingrid Bachér 	protestierte 	. 
protestieren_s31318_f0	Studentenkeywordtag 	protestieren 	gegen Bildungsnotstand 
protestieren_s31321_f0	Am Freitag wurde in rund 15 Universitäten und Hochschulen 	protestiert 	, erstmals auch an Fakultäten in Paris . 
protestieren_s34150_f1	Siekeywordtag 	protestierten 	, die Wahlhelfer ihres Kandidaten seien an mehreren Orten daran gehindert worden , die Auszählung von Stimmen zu kontrollieren . 
protestieren_s34256_f1	Mit der Kürzung der Mittelmeerhilfe 	protestierten 	die Abgeordneten gegen einen Beschluß des EU-Gipfels ohne Rücksprache . 
protestieren_s34547_f1	Tausende Dasa-Beschäfigte wollen heute gegen das Sparkonzept 	protestieren 	. 
protestieren_s34561_f1	Gegner des umstrittenen Gasprojekts , das Shell zusammen mit der nigerianischen Regierung sowie Unternehmen aus Italien und Frankreich im Stammesgebiet der Ogoni verwirklichen will , 	protestierten 	am Wochenende vor Shell-Tankstellen in Großbritannien . 
protestieren_s34585_f1	Rund 3000 Franco-Gegner , die sich am Sonntag an anderer Stelle in Madrid versammelt hatten , waren einem Aufruf zumeist linksradikaler Gruppierungen gefolgt und hatten gegen Faschismus 	protestiert 	. 
protestieren_s34615_f1	Der Kroate , wolle damit gegen die Ausweitung des Brcko-Korridors 	protestieren 	, teilte Sacirbey mit . 
protestieren_s34624_f1	Studentenvertreter aus fünf französischen Universitäten haben am Wochenende zu einem unbefristeten Streik an allen Schulen und Hochschulen des Landes aufgerufen , um gegen die katastrophalen Zustände zu protestieren . 
protestieren_s35341_f2	Pazifisten in den USA beriefen sich auf die Anklagepunkte Verbrechen gegen den Frieden und gegen die Menschlichkeit , wenn siekeywordtag gegen den Vietnamkrieg 	protestierten 	. 
protestieren_s35875_f1	Im Namen seiner eigenen Organisation und von Fundamentalistengruppen aus zwölf islamischen Ländern schickte der Chef der pakistanischen `` Gamaa '' , Kadhi Hussein Ahmed , ein Telegramm an Mubarak , in dem erkeywordtag das harte Vorgehen gegen Moslem-Aktivisten mißbilligte und gegen den Prozeß 	protestierte 	, den die ägyptische Militärjustiz derzeit 82 Mitgliedern der Moslembruderschaft macht . 
protestieren_s36430_f2	Gegner des umstrittenen Gasprojekts , das Shell mit der nigerianischen Regierung sowie Unternehmen aus Italien und Frankreich im Gebiet der Ogoni verwirklichen will , 	protestierten 	am Wochenende vor Shell-Tankstellen in Großbritannien . 
