rechtfertigen_s519_f1	Es gibt Situationen , in denen es moralisch und historisch 	gerechtfertigt 	, ja sogar geboten ist , Gewalt anzuwenden . 
rechtfertigen_s5900_f2	Auf ihrer dreitägigen Delegiertenversammlung in Essen `` verstand '' zwar die Mehrheit die Auffassung einer Minderheit , die `` einkeywordtag begrenzteskeywordtag militärischeskeywordtag Eingreifenkeywordtag '' in kriegerische Konflikte wie den in Bosnien für 	gerechtfertigt 	hält , `` um schutzlosen Menschen zu helfen und dadurch größere Gewalt zu vermeiden '' . 
rechtfertigen_s5904_f2	In seinem Papier `` Wider einen kommentarlosen Pazifismus '' hatte der Vorstand ein militärisches Eingreifen `` um der Glaubwürdigkeit unseres Friedenshandelns willen '' dann für 	gerechtfertigt 	gehalten , `` wenn - wie im Fall von Srebrenica und Zepa - Menschen in unerträglichem Maß schutzlos der Gewalt von Aggressoren ausgeliefert sind '' . 
rechtfertigen_s5906_f2	Durch eine Zustimmung zu Militäreinsätzen dürfe keine Politik 	gerechtfertigt 	werden , die `` sich selbst in eine angebliche ultima ratio-Situation gebracht hat '' . 
rechtfertigen_s7420_f2	Eine Koalition der Verlierer ist vor den Wählern nur zu rechtfertigen , wenn die sachliche Notwendigkeit überzeugend begründet werden kann . 
rechtfertigen_s7571_f1	15. Diese Rolle zu übernehmen , 	rechtfertigen 	keine Gründe der sog. Staatsräson . 
rechtfertigen_s7628_f1	Dabei versuchte Amirkeywordtag nach Angaben des israelischen Rundfunks sogar , die Tat zu rechtfertigen . 
rechtfertigen_s8535_f1	Und der besagt : Die Beteiligung am politischen Strafrecht der DDR , der Mangel an kritischer Auseinandersetzung mit totalitären Überzeugungen 	rechtfertigen 	den Ausschluß von der Dritten Gewalt . 
rechtfertigen_s8640_f1	Eine Entlassung von ehemaligen DDR-Hochschullehrern aus dem Staatsdienst ist nach Ansicht des Bundesarbeitsgerichtes nur dann 	gerechtfertigt 	, wenn sie sich in besonderer Weise mit dem SED-Staat identifiziert hätten . 
rechtfertigen_s8763_f1	Ob diese Einschätzung 	gerechtfertigt 	ist , wird sich in den nächsten Monaten , vielleicht sogar erst in über einem Jahr erweisen . 
rechtfertigen_s8808_f1	Der Ex-Chef des israelischen Geheimdienstes Schin Beth , Jaakow Peri , sprach sich dafür aus , extremistische Juden , diekeywordtag Mordkeywordtag 	rechtfertigten 	, hart zu bestrafen . 
rechtfertigen_s9227_f1	Die Landesverteidigung läßt sich nur als `` Sicherheitsvorsorge '' 	rechtfertigen 	/ 
rechtfertigen_s9258_f2	In einer Situation , in der es keine konkrete militärische Bedrohung für das eigene Territorium gibt , lassen sich Bemühungen um die Landesverteidigung nur im Sinne einer `` Sicherheitsvorsorge '' plausibel machen und 	rechtfertigen 	. 
rechtfertigen_s9331_f2	Die Luftwaffe steht vor den Aufgaben , 1. die bodengestützte Flugabwehr auf relativ niedrigem Kostenniveau zu stabilisieren ( mehrkeywordtag ist in der gegenwärtig absehbaren Sicherheitslage nicht zu rechtfertigen ) , 2. die Zahl der Kampfflugzeuge - ebenfalls im Einklang mit der Sicherheitslage - zu reduzieren und die bisher bestehende Angriffslastigkeit zu korrigieren und 3. strategische Transportmittel vor allem für Peacekeeping-Missionen bereitzustellen . 
rechtfertigen_s9513_f2	Dabei gibt es nichtskeywordtag zu rechtfertigen . 
rechtfertigen_s9568_f2	Du , statt mir zu helfen , kein Star zu werden , stellst Dich hin und verlangst , daß ichkeywordtag michkeywordtag 	rechtfertige 	, und läßt mir nur die Wahl zwischen Ohnmacht und Widerspruch . 
rechtfertigen_s9830_f1	Ob Nigerias Zukunft seinen Optimismus 	rechtfertigt 	? 
rechtfertigen_s11834_f1	Welcher wissenschaftliche Wert einem solchen Befund zukommt , ob erkeywordtag vor allem die These von einem deutschen Sonderweg 	rechtfertigt 	, blieb umstritten . 
rechtfertigen_s14439_f1	Allerdings läßt sich bei herabsetzenden Äußerungen unter einer Sammelbezeichnung die Grenze zwischen einem Angriff auf die persönliche Ehre , die Art. 2 Abs. 1 in Verbindung mit Art. 1 Abs. 1 GG schützt und diekeywordtag nach Art. 5 Abs. 2 GG Beschränkungen der Meinungsfreiheit 	rechtfertigt 	, und einer Kritik an sozialen Phänomenen , staatlichen oder gesellschaftlichen Einrichtungen oder sozialen Rollen und Rollenerwartungen , für die Art. 5 Abs. 1 Satz 1 GG gerade einen Freiraum gewährleisten will , nicht scharf ziehen . 
rechtfertigen_s14476_f1	Den Beschwerdeführern ging es indessen erkennbar um eine Auseinandersetzung in der Sache , und zwar um die Frage , ob Krieg und Kriegsdienst und die damit verbundene Tötung von Menschen sittlich 	gerechtfertigt 	sind oder nicht . 
rechtfertigen_s15680_f1	Und er bezeichnet es etwas knapp als `` nicht hinnehmbar '' , daß die Ayatollahs den Mord am israelischen Premierminister Yitzhak Rabin 	gerechtfertigt 	haben . 
rechtfertigen_s16106_f1	Major hatte nach Berichten aus Konferenzkreisen noch versucht , eine Klausel einzubauen , diekeywordtag Atomversuchekeywordtag 	rechtfertigt 	. 
rechtfertigen_s17689_f2	Mittel- und langfristig kann die Position des Hochlohnlands Deutschland nur durch Produktivitätsvorsprünge 	gerechtfertigt 	und gesichert werden . 
rechtfertigen_s18968_f2	Durch die Zusammenfassung der Ressorts seien zwei beamtete Staatssekretäre nicht mehr zu rechtfertigen . 
rechtfertigen_s19345_f1	Mit der Entscheidung reagierte die Bundestagsmehrheit darauf , daß Teheraner Regierungspolitiker den Mord an Israels Ministerpräsident Yitzhak Rabin 	gerechtfertigt 	hatten . 
rechtfertigen_s19622_f1	Im Löwenkäfig habe es ohnehin keinen Platz für ein weiteres Tier gegeben , 	rechtfertigte 	der Zoodirektor sein Tauschgeschäft . 
rechtfertigen_s20107_f1	Keine Ideologie , weder die Religion noch der Patriotismus , kann Mordekeywordtag 	rechtfertigen 	. 
rechtfertigen_s20529_f2	einige Staatschefs hatten das Gefühl , sich für ihr Zögern 	rechtfertigen 	zu müssen . 
rechtfertigen_s20721_f2	Das zweite Verfahren gegen den Stasi-Chef Erich Mielke , in dem dieserkeywordtag sich wegen der Mauertoten zu rechtfertigen hatte , stellte er wegen dessen Verhandlungsunfähigkeit durch Urteil ein . 
rechtfertigen_s20896_f1	Nichtskeywordtag könne aber 	rechtfertigen 	, daß iranische Regierungspolitiker den Mord an Israels Ministerpräsident Yitzhak Rabin gebilligt hätten . 
rechtfertigen_s20997_f1	Die Tatsache allein , daß für eine Diebestour ein Auto benutzt wurde , 	rechtfertigt 	nicht den Entzug des Führerscheins . 
rechtfertigen_s23154_f1	Die Gewerkschaftsforscher wenden sich bei der Diskussion über die Ursachen dagegen , eine Gefährdung des Standorts Deutschland an die Wand zu malen , um damit Einschnitte ins soziale Netz zu rechtfertigen . 
rechtfertigen_s24717_f1	All die biblischen `` Taten '' ( Versprechen ) können die Vertreibung auch nur eines Palästinensers aus seiner Heimat Palästina nicht 	rechtfertigen 	. 
rechtfertigen_s25242_f1	Weil iranische Regierungspolitiker den Mord an Israels Ministerpräsidenten Yitzhak Rabin 	gerechtfertigt 	hatten , stimmte eine Bundestagsmehrheit am Freitag gegen Kinkels Willen dafür , den iranischen Außenminister Ali Akbar Welayati von der ursprünglich für diese Woche vorgesehenen Konferenz des Auswärtigen Amtes auszuladen . 
rechtfertigen_s25250_f2	Scharping und Schröder 	rechtfertigen 	sichkeywordtag 
rechtfertigen_s26831_f1	`` Wir haben ja immer gesagt , daß ein Benachteiligungs-Verbot wegen Behinderung keine Besserung für die Betroffenen bringen wird '' , 	rechtfertigen 	die Gegner des Verfassungsgrundsatzes gegen die Diskriminierung Behinderter ihr Nichtstun . 
rechtfertigen_s29506_f1	Daß Deng dieses Programm den Weg zum `` Sozialismus chinesischer Prägung '' nannte , ist insofern 	gerechtfertigt 	, als er den Begriff `` Sozialismus '' schon immer mit dem Erfolg Chinas gleichsetzte . 
rechtfertigen_s30769_f1	Die Fehler von gestern , die schmählich waren und beschämend , 	rechtfertigen 	keineswegs ein Versagen heute . 
rechtfertigen_s32461_f1	Nur ein kritischer Journalismus auch aus Sicht der Frauen , auf Grundlage differenzierter und hintergründiger Recherchen , kann langfristig öffentlich-rechtliche Gebühren 	rechtfertigen 	. 
rechtfertigen_s34263_f1	Steinle sagte , es sei 	gerechtfertigt 	, daß Fehler in den Prüfungsantworten dazu führten , daß der Test nicht bestanden sei . 
rechtfertigen_s37137_f1	Die Idealkonstellation niedriger Zinsen , des festen Dollar und höherer Unternehmensgewinne 	rechtfertigt 	nach Ansicht von Banken die Rekorde . 
rechtfertigen_s37310_f1	Die Europäische Union ( EU ) berief einen Ministerrat nach Genf ein , der entscheiden soll , ob die erreichten Ergebnisse ein Abkommen 	rechtfertigen 	. 
rechtfertigen_s37823_f1	Der 50. Geburtstag des Firmenchefs oder das fünfjährige Bestehen eines Supermarktes 	rechtfertigen 	keine Sonderverkäufe . 
rechtfertigen_s37963_f1	Der Aufsichtsratschef der Beteiligungs AG , Gerhard Wolf aus dem Vorstand des Chemiemultis BASF , 	rechtfertigte 	die im vorigen August bekanntgegebene Trennung , die nach einem Verbot des Kartellamtes bisher nicht umgesetzt werden konnte . 
rechtfertigen_s38491_f2	Wenn aber wie jetzt zwei Drittel der realisierten Gewinne für Steuern draufgingen , seien Anteilsverkäufekeywordtag kaum vor den Aktionären zu rechtfertigen . 
rechtfertigen_s38534_f1	Schrumpft die Wirtschaftsleistung um weniger als 0,75 Prozent , soll dagegen wiederum `` in der Regel '' keine Ausnahme gegeben sein , diekeywordtag ein über drei Prozent hinausgehendes Defizit 	rechtfertigt 	. 
