reduzieren_s436_f1	Gerade die Schule ist 	reduziert 	darauf , daß man sprachlich gut drauf sein muß , in rationaler Beweisführung und Stil glänzen kann . 
reduzieren_s1576_f1	Damit könnte der Einfluß von Staat und Parteien 	reduziert 	werden . 
reduzieren_s3789_f1	Im Falle Vibro-Ram soll auf Betreiben des Finanzministeriums die Steuernachforderung von knapp 1,5 Millionen Mark auf rund 700 000 Mark 	reduziert 	worden sein , angeblich um den Konkurs der Firma abzuwenden . 
reduzieren_s5952_f1	Wäre dort gewählt worden , hätte sich die Mehrheit des ANC 	reduziert 	, Inkatha wäre wohl eine der drei größten Parteien geblieben . 
reduzieren_s6677_f1	Die drei Partner wollen mit dem Joint-venture , das bereits im ersten Geschäftsjahr über 100 Millionen Dollar umsetzen soll , die steigenden Forschungs- und Entwicklungskosten 	reduzieren 	und ihre Produktionskapazitäten besser ausnutzen . 
reduzieren_s7175_f1	Die Vereinigten Energiewerke ( Veag ) in Berlin , die nach dem Mauerfall die Verbund-Anlagen übernahmen , haben den Staub-Ausstoß ihrer Kraftwerke auf einen Bruchteil des einstigen Volumens 	reduziert 	. 
reduzieren_s7182_f1	Es wird fünf Milliarden Mark kosten , alleine den Ausstoß der Schadstoffe zu reduzieren . 
reduzieren_s7249_f1	Wirkeywordtag 	reduzieren 	große Rätsel zum Rentabilitätsfaktor , Ideal und Dekadenz wird am Zwitter Osterhase / Weihnachtsmann kenntlich , und die `` Sehnsucht nach Glück '' reagiert sich im Blick auf das Portemonnaie ab . 
reduzieren_s8652_f1	Durch die Untertunnelung 	reduzieren 	sich die 16 Gleise des bisherigen Kopfbahnhofs auf nur noch acht . 
reduzieren_s9269_f1	Bis zum Jahre 2005 ist die Präsenzstärke unserer Streitkräfte von ca. 340 000 Soldaten ( 1995/96 ) auf 250 000 zu reduzieren . 
reduzieren_s9297_f2	Diese Basis 	reduziert 	sich auf ca. 175 000 der Bundeswehr zur Verfügung stehende Rekruten , wenn die gegenwärtige KDV-Neigung , die geltenden Tauglichkeitsstandards und Ausnahmeregelungen fortgeschrieben sowie plausible Schätzungen des künftigen Personalbedarfs von Polizei , BGS , Katastrophenschutz und Entwicklungsdienst vorgenommen werden . 
reduzieren_s9331_f1	Die Luftwaffe steht vor den Aufgaben , 1. die bodengestützte Flugabwehr auf relativ niedrigem Kostenniveau zu stabilisieren ( mehr ist in der gegenwärtig absehbaren Sicherheitslage nicht zu rechtfertigen ) , 2. die Zahl der Kampfflugzeuge - ebenfalls im Einklang mit der Sicherheitslage - zu reduzieren und die bisher bestehende Angriffslastigkeit zu korrigieren und 3. strategische Transportmittel vor allem für Peacekeeping-Missionen bereitzustellen . 
reduzieren_s9377_f1	Dabei wird die Kostenentlastung , die durch die vorgesehene Ausweitung des Anteils der Grundwehrdienstleistenden möglich wird , weitgehend dadurch neutralisiert , daß sich die Zahl der Zivilbediensteten nicht im Maße des militärischen Abbaus 	reduzieren 	läßt . 
reduzieren_s9560_f1	Du siehst michkeywordtag politisch festgefahren , darauf 	reduziert 	, Manifeste und Petitionen zu unterschreiben , zum `` Super-Sozialarbeiter '' geworden : 
reduzieren_s10849_f1	Ecuador , nach eigenen Angaben international größter Bananenproduzent , will die Fläche seiner Plantagen freiwillig um 16 Prozent auf 105 000 Hektar 	reduzieren 	. 
reduzieren_s10901_f1	Ursprünglich wollte die größte deutsche Reederei alle 18 Schiffe in Singapur registrieren lassen und damit ihre Personalkosten um jährlich rund 40 Millionen Mark 	reduzieren 	. 
reduzieren_s10996_f1	Dabei ist es medizinisch erwiesen , daß Lachenkeywordtag Spannungen abbaut und Streßkeywordtag 	reduziert 	. 
reduzieren_s11693_f1	die Zahl der Kinder , die an den Hochschulen studieren und aus einfachen Verhältnissen stammen , hat sich in den letzten zwölf Jahren 	reduziert 	von 23 Prozent auf 14 Prozent . 
reduzieren_s16610_f1	- `` Können die Lohnnebenkosten , die Kosten der Arbeit , so 	reduziert 	werden , daß die Schaffung neuer Arbeitsplätze lohnt , ohne das soziale Sicherungssystem durch Fremdaufgaben zu ruinieren ? '' 
reduzieren_s16614_f1	Wer sich den hier zitierten Fragen stellt und qualifizierte Antworten erarbeitet , erkennt schnell , daß Wirtschaftspolitikkeywordtag nicht auf Branchen- und Industriepolitik oder gar Unterstützung eines einzelnen Unternehmens 	reduziert 	werden darf . 
reduzieren_s16966_f1	Vor gut 50 Jahren von Muttern auf der Flucht gerettet , mit pommerschen Gänsedaunen gestopft , deren Menge sich seither auf die Hälfte 	reduziert 	haben dürfte , und mit x-mal erneuertem Inlett , ist es mir unentbehrliche Begleitung meiner Traumreisen geworden . 
reduzieren_s17024_f1	In der Saison 1994 / 95 	reduzierte 	sich die Zahl der deutschen Gäste in dieser Region von 1,29 auf 1,141 Millionen . 
reduzieren_s17050_f1	Also hat Ameropakeywordtag die Kapazität für Österreich in diesem Winter um zehn Prozent , die Angebote in der Schweiz auf nur noch sechs Skiorte 	reduziert 	. 
reduzieren_s19400_f1	Bei plutoniumhaltigen Mischoxid-(MOX)-Brennelementen solle die Sicherheit `` auf Initiative der deutschen Delegation '' weiter 	reduziert 	werden , meinte Nimsch . 
reduzieren_s19767_f1	So könnten die Unternehmen ihre Kosten deutlich 	reduzieren 	, was insbesondere exportorientierten Firmen zugute komme . 
reduzieren_s19883_f1	Unternehmen dagegen 	reduziert 	siekeywordtag die ohnehin kaum vorhandenen finanziellen Spielräume . 
reduzieren_s19933_f1	Die Fremdkapitaldecke , die bei den bundesdeutschen Unternehmen im Schnitt bei 82 Prozent liegt , würde durch am Arbeitsplatz orientiertes Arbeitnehmerkapital 	reduziert 	, so daß auch die Zinsbelastung der Unternehmen sinkt . 
reduzieren_s22277_f1	Wenn dem so ist - und niemand kann dies pauschal als dummes Zeug abtun - , dann lassen sich die Probleme nicht auf Scharping 	reduzieren 	, dann bündelt sich im Vormann höchstens das ganze Elend der Partei , dann ist er nur ein Teil des Ganzen . 
reduzieren_s23399_f1	In Niedersachsen , Hamburg und Schleswig-Holstein werde die Grundausstattung noch weiter 	reduziert 	. 
reduzieren_s23640_f1	In Niedersachsen , Hamburg und Schleswig-Holstein werde die Ausstattung noch weiter 	reduziert 	. 
reduzieren_s25532_f1	Da 	reduzieren 	sich Hoffnungen der deutschen Wirtschaft auf den Satz : `` Präsent sein ist alles . '' 
reduzieren_s27679_f1	Die Bahncards werden zu Beginn des nächsten Jahres nicht teurer , wodurch sich für deren Inhaber der allgemeine Aufschlag auf die Hälfte 	reduziert 	. 
reduzieren_s27685_f1	`` In den neuen Bundesländern 	reduziert 	sich der bisherige Preisvorteil - wie angekündigt - gegenüber Westdeutschland auf 10 Prozent '' , heißt es in der offiziellen Mitteilung . 
reduzieren_s27749_f1	Auch Tierversuche hätten ergeben , daß Tiere , deren tägliche Futterrationen um die Hälfte 	reduziert 	wurden , eine erhöhte Melatoninkonzentration aufwiesen . 
reduzieren_s28492_f1	Für neun Stoffe wird die Chemie ihre Einleitungen bis zum Jahre 2000 von derzeit 1300 auf 470 Tonnen pro Jahr 	reduzieren 	. 
reduzieren_s29500_f1	Solange die KPC an demkeywordtag ( noch ) geplanten Zusammenhangkeywordtag - wie 	reduziert 	auch immer - ihrer Ökonomie festhält , besteht nämlich der ausländische Verdacht , daß der Yuan doch noch als `` künstlich '' staatlich fixierter beurteilt wird , weil er noch immer als innerchinesisches `` Verrechnungsgeld '' auch die Verluste der Staatsbetriebe mitträgt . 
reduzieren_s30069_f1	Umgekrempelt wird das Transportgeschäft bei Log Sped und die Flottenkapazität um 60 Prozent 	reduziert 	. 
reduzieren_s30554_f1	Nach Juppés Ankündigungen soll der kumulierte Fehlbetrag der Sozialversicherung , der bis Ende des nächsten Jahres auf etwa 250 Milliarden Francs ( circa 75 Milliarden Mark ) veranschlagt wird , 1996 durch zusätzliche Einnahmen und Ausgabenkürzungen um 33 Milliarden Francs 	reduziert 	und dann im Lauf der folgenden zwölf Jahre ganz abgetragen werden . 
reduzieren_s31237_f1	Härtere Strafen gegen Raser seien nötig , um Verkehrsunfälle mit Schwerverletzten und Toten spürbar zu reduzieren . 
reduzieren_s31302_f3	Dabei soll die Menge an Zink von derzeit 270 Tonnen jährlich auf 100 	reduziert 	werden , die an Chrom von 50 auf 20 Tonnen . 
reduzieren_s31304_f1	Größte Gruppe sind die organischen Halogenverbindungen ( AOX ) , diekeywordtag von 900 Tonnen auf ein Drittel 	reduziert 	werden sollen . 
reduzieren_s31486_f1	Kinkel verwies darauf , daß auf der Grundlage des `` größten Abrüstungsvertrags der Geschichte '' fast 50 000 schwere Waffensysteme zwischen Atlantik und Ural 	reduziert 	worden seien . 
reduzieren_s35028_f1	Die öffentliche Verschuldung muß vielmehr zunehmen , wenn auf Umverteilungen verzichtet wird , und siekeywordtag läßt sich ohne Steuererhöhungen nicht 	reduzieren 	. 
reduzieren_s35112_f1	In vier Jahren 	reduzierte 	sich die Zahl ihrer westdeutschen Mitglieder von 676 000 auf 624 000 . 
reduzieren_s35638_f1	Auch der australische Regierungschef Paul Keating erklärte , sein Land werde die Einfuhrzölle auf 3000 Warengruppen ein Jahr früher als geplant 	reduzieren 	. 
reduzieren_s36969_f1	Die Dresdner Bank habe ihr Engagement , daskeywordtag in Stufen auf zuletzt knapp fünf Prozent 	reduziert 	wurde , inzwischen über die Börse auf Null gestellt . 
reduzieren_s37050_f1	Auf diesem Gebiet fahren die Dortmunder seit langem Verlust ein und 	reduzieren 	die Belegschaft . 
reduzieren_s37436_f1	Der steuerlich nutzbare Verlustvortrag wurde durch Verrechnung mit Gewinnen zuletzt um 100 Millionen auf 300 Millionen Mark 	reduziert 	. 
reduzieren_s37495_f1	Ziel bleibe es aber , die industriellen Beteiligungen zu reduzieren . 
reduzieren_s37560_f1	Im vergangenen Jahr sei es der Gruppe trotz einer konjunkturell schlechten Lage gelungen , das Defizit im reinen Geschäftsbetrieb auf noch 409 Millionen Franc zu reduzieren , heißt es weiter . 
reduzieren_s37882_f1	Die Belegschaft wird schon des längeren stark 	reduziert 	. 
reduzieren_s39940_f1	Nachdem die Belegschaft bis 1996 auf 3034 Leute 	reduziert 	wurde , würden `` vielleicht noch 50 '' Arbeitsplätze im Rahmen der Fluktuation eingespart . 
