Regierung_s27_f1	Ihm gelingt es aber nicht , den Koloß , der der Regierungkeywordtag in Washington mehr ähnelt als jeder andere Konzern , in Schwung zu bringen . 
Regierung_s43_f1	Schließlich sei die Regierungkeywordtag auch für die nationale Sicherheit und allgemeine Wohlfahrt verantwortlich . 
Regierung_s68_f1	Als Rao die Regierungkeywordtag übernahm , gab es praktisch kein Wirtschaftswachstum mehr . 
Regierung_s89_f1	Auch an die heißesten Eisen hat sich die neue Regierungkeywordtag noch nicht herangetraut , obwohl eine durchgreifende wirtschaftliche Veränderung gleichermaßen drastische wie unpopuläre Schritte verlangt . 
Regierung_s470_f1	Wie im Fall einiger Mitglieder der Künstlervereinigung UNEAC , die vor einem Jahr ähnliche Reformen anregten , verweigert die Regierungkeywordtag von Präsident Fidel Castro Andersdenkenden jede Möglichkeit des Dialogs . 
Regierung_s526_f1	Weder die Position der SPD noch der Ruf der Regierungkeywordtag nach Kampfeinsätzen helfen weiter . 
Regierung_s549_f1	Eine von der Regierungkeywordtag bestellte Kommission zu den Parteienvermögen , eine vom Bundespräsidenten eingesetzte Kommission zur Parteienfinanzierung und eine von der Bundestagspräsidentin berufene Kommission zum Abgeordnetenrecht . 
Regierung_s682_f1	Die belgischekeywordtag Regierungkeywordtag hat am Wochenende angekündigt , ihre Ausgaben für Verteidigung einzuschränken und die Streitkräfte umzuorganisieren . 
Regierung_s704_f1	Die Firmen gewannen eine Ausschreibung für das ausschließliche Verhandlungsrecht mit der Regierungkeywordtag . 
Regierung_s763_f1	Als die Konservativen im Frühjahr 1990 ankeywordtag die Regierungkeywordtag kamenkeywordtag , kontrollierte Athen direkt oder indirekt etwa siebzig Prozent der Wirtschaft . 
Regierung_s772_f1	Wie nicht anders zu erwarten , rutschten die meisten dieser Unternehmen nach ihrer Verstaatlichung immer tiefer in die roten Zahlen , wurden sie doch dazu mißbraucht , treuen Parteigängern der Regierungkeywordtag meist ohne Rücksicht auf deren Qualifikation gut dotierte Management-Jobs zu verschaffen . 
Regierung_s893_f1	Später behauptete die japanischekeywordtag Regierungkeywordtag jedoch , die vier südlichen Inseln gehörten nicht zu den Kurilen , sie seien mithin japanisches Territorium . 
Regierung_s900_f1	Bedächtige japanische Politker warnten ihrekeywordtag Regierungkeywordtag : 
Regierung_s948_f1	Harte Töne der Regierungkeywordtag gegen Nationalkongreß 
Regierung_s950_f1	Der Präsident des Afrikanischen Nationalkongresses ( ANC ) , Nelson Mandela , hat der Regierungkeywordtag Südafrikaskeywordtag am Wochenende vorgeworfen , sie versuche , mit `` blanker Propaganda '' ihre Macht zu erhalten und steuere das Land in einen Konfrontationskurs . 
Regierung_s952_f1	Er warf der Regierungkeywordtag auch wieder vor , sie unterstütze die Zulubewegung Inkatha , um den ANC zu schwächen . 
Regierung_s956_f1	Die Regierungkeywordtag hatte vergangene Woche scharf auf Bedingungen des ANC zur Wiederaufnahme von Verhandlungen reagiert . 
Regierung_s960_f1	`` Während die Regierungkeywordtag sich und das Land von der Apartheid befreit hat '' , hieß es in dem Dokument , `` hat sich der ANC noch immer nicht dem demokratischen politischen Wettbewerb angepaßt . '' 
Regierung_s961_f1	Den Angriff führte die Regierungkeywordtag vor allem auf dem Feld , auf dem sie selbst nach dem Massaker in Boipatong am ärgsten in Bedrängnis geraten war : der anhaltenden Gewalt . 
Regierung_s963_f1	Die Regierungkeywordtag erklärte sich allerdings auch bereit , internationale Experten zur Aufklärung von Gewaltakten ins Land zu holen . 
Regierung_s967_f1	De Klerk bestritt erneut jede Beteiligung der Regierungkeywordtag an den Gewaltakten : 
Regierung_s970_f1	Schließlich scheint sich die Regierungkeywordtag auch auf jenem Feld zu bewegen , auf dem die Verhandlungen im Rahmen der `` Konferenz für ein demokratisches Südafrika '' ( Codesa ) ins Stocken geraten waren : 
Regierung_s972_f1	Bislang wollte die Regierungkeywordtag jeder Partei , die eine bestimmte Prozentzahl erreicht , im `` Senat '' dieselbe Anzahl von Sitzen zuteilen , was gemeinsam mit der Forderung nach Dreiviertelmehrheiten einer Veto-Möglichkeit für die weiße Bevölkerungsminderheit gleichgekommen wäre . 
Regierung_s1033_f1	Die Gewerkschaften wollen die Massenproteste gegen einen Karenztag nach der Sommerpause verstärken , falls die Regierungkeywordtag ihren Plan dann habe noch nicht fallen lassen . 
Regierung_s1044_f1	Bundespräsident Richard von Weizsäcker hat die bayerischekeywordtag Regierungkeywordtag zur aktiven Versöhnung mit der CSFR gemahnt . 
Regierung_s1045_f1	In Anspielung an die Ablehnung des Vertrages mit dem östlichen Nachbarn durch die Regierungkeywordtag im Freistaat sagte er am Samstag im oberfränkischen Wunsiedel , Hadern dürfe nicht die Chancen der Zusammenarbeit mit den Nachbarn im Osten verbauen . 
Regierung_s1132_f1	Italienskeywordtag Regierungkeywordtag nahm Hürde 
Regierung_s1136_f1	Der Senat hatte am Donnerstag mit 173 gegen 140 Stimmen für die von Christdemokraten , Sozialisten , Sozialdemokraten und Liberalen gebildetekeywordtag Regierungkeywordtag votiert . 
Regierung_s1166_f1	Offiziell spricht die Regierungkeywordtag in Algier nicht von einer Verschwörung . 
Regierung_s1177_f1	Die Regierungkeywordtag wolle in jeder der rund 9300 Moscheen des Landes moslemische Prediger ernennen , teilte er mit . 
Regierung_s1264_f1	In der vergangenen Woche waren die Friedensgespräche zwischen der früher marxistischen Regierungkeywordtag und der einst von Südafrika unterstützten Renamo abgebrochen worden . 
Regierung_s1425_f1	Außerdem solle die neue Regierungkeywordtag Ausweisungen von Palästinensern und das Zerstören von Häusern als Strafmaßnahme einstellen . 
Regierung_s1494_f1	Regierungkeywordtag in Rom kündigt Preisstopp und Sparprogramm an 
Regierung_s1499_f1	Die Regierungkeywordtag selbst kündigte nach einer Kabinettsitzung einen Stopp bei den öffentlichen Preisen und ein Sparprogramm zur Eindämmung des Etatdefizits an . 
Regierung_s1509_f1	Auch die Regierungkeywordtag erklärte zudem ihre Entschlossenheit , die Stabilität der Landeswährung Lira zu sichern , da ein stabiler Wechselkurs im Kampf gegen die Inflation ein wesentlicher Faktor sei . 
Regierung_s1769_f1	Und zur Vollständigkeit der verkehrten Welt gehört auch , daß die Arbeitgeber keinen Grund sahen , sich negativ zu den Kurzstreiks zu äußern und sich mit der Bonnerkeywordtag Regierungkeywordtag gemein zu machen . 
Regierung_s1911_f2	Nach dem Scheitern der Regierungkeywordtag Olszewskikeywordtag und dem einmonatigen vergeblichen Bemühen des von Präsident Walesa vorgeschlagenen neuen Premiers Pawlak , ein Kabinett zu bilden , könnte Polen nun doch eine parlamentarisch gut abgesicherte Regierungkeywordtag unter Führung einer Frau ins Haus stehen . 
Regierung_s2101_f1	Die neue Regierungkeywordtag Rest-Jugoslawienskeywordtag hat eine Beendigung der Kämpfe in Bosnien und Kroatien versprochen und die Konferenz für Sicherheit und Zusammenarbeit in Europa ( KSZE ) dringend ersucht , ihr dafür eine Frist von 100 Tagen einzuräumen . 
Regierung_s2104_f1	`` Wir bitten um Ihre Geduld für 100 Tage , die traditionelle Frist , die jeder Regierungkeywordtag eingeräumt wird , damit die Richtung ihres Handelns und ihre politische Wirksamkeit erkennbar wird . 
Regierung_s2106_f1	Er wies darauf hin , daß er in dem noch aus Serbien und Montenegro bestehenden Jugoslawien eben erst die Aufgabe übernommen habe , eine Regierungkeywordtag zu bilden , die ganz energisch einen `` Kurs des Friedens in Bosnien und Kroatien '' verfolgen werde . 
Regierung_s2110_f1	Sein russischer Kollege Jewgeni Gussarow , dessenkeywordtag Regierungkeywordtag gegen den Ausschluß Jugoslawiens ist , meinte dagegen , die Bitte um eine 100tägige Frist sollte ernsthaft geprüft werden . 
Regierung_s2164_f1	Ein Ausschuß zur Untersuchung politischer Gewalttaten konnte keine Beweise dafür finden , daß die südafrikanischekeywordtag Regierungkeywordtag in das Massaker von Boipatong verwickelt war , bei dem am 17. Juni 42 Menschen ermordet wurden . 
Regierung_s2221_f1	Die Regierungkeywordtag von Angola erhält von der Europäischen Gemeinschaft rund vier Millionen Mark zur Vorbereitung der für Ende 1992 geplanten freien Wahlen . 
Regierung_s2339_f1	Seinekeywordtag Regierungkeywordtag gefährde den sozialen Ausgleich . 
Regierung_s2377_f1	Unter der Leitung von Ministerpräsident Fuad Maassum ist im nordirakischen Erbil die erste kurdischekeywordtag Regierungkeywordtag gebildet worden . 
Regierung_s2381_f1	Schließlich strebe seinekeywordtag Regierungkeywordtag an , eine funktionierende Verwaltung zu schaffen . 
Regierung_s2386_f1	Die Regierungkeywordtag unter Leitung des 54 Jahre alten Philosophieprofessors Maassum wurde nach den ersten freien Wahlen der Kurden im Nordirak am 19. Mai gebildet . 
Regierung_s2392_f1	Die Regierungkeywordtag Maassums , dessen Stellvertreter und Innenminister Roch Nuri der konkurrierenden Demokratischen Partei Kurdistans angehört , setzt sich aus 15 Mitgliedern zusammen . 
Regierung_s2434_f1	Die Regierungkeywordtag in Ankara teilte weiter mit , gegen 135 Kurden sei Haftbefehl erlassen worden , die vor einer Woche bei einer Straßenblockade festgenommen worden waren . 
Regierung_s2525_f1	Innenminister Paul Quiles kündigte ein entschlossenes Vorgehen der Regierungkeywordtag gegen die Fernfahrer an . 
Regierung_s2529_f1	Vorwürfe der Opposition , daß die Regierungkeywordtag handlungsunfähig sei , wies der Minister entschieden zurück . 
Regierung_s2554_f1	Die Regierungkeywordtag schließe die Entsendung von US-Bodentruppen in das Bürgerkriegsgebiet jedoch weiterhin aus . 
Regierung_s2583_f1	Die vier wichtigsten Parteien der britischen Provinz Nordirland haben am Montag in London Gespräche mit der Regierungkeywordtag der Republik Irland aufgenommen . 
Regierung_s2586_f1	Seit der Unabhängigkeit der Republik Irland , also seit 70 Jahren , ist es das erste Mal , daß die verschiedenen Parteien der nordirischen Unionisten offiziell mit der Dublinerkeywordtag Regierungkeywordtag verhandeln . 
Regierung_s2722_f1	`` In den Monaten seit dem Regierungswechsel ist , im Gegensatz zu den Ankündigungen der neuen Regierungkeywordtag , kein Fortschritt in Menschenrechtsfragen festzustellen . 
Regierung_s2724_f1	Zwar brüstet sich die Regierungkeywordtag in Ankara nun mit einer Reform des Strafprozeßrechts , die helfen soll , Polizeiwillkür und Folter abzuschaffen . 
Regierung_s2727_f1	Um das katastrophale Menschenrechts-Image der Türkei aufzupolieren , schaffte zwar schon die konservativekeywordtag Regierungkeywordtag im Frühjahr vergangenen Jahres die berüchtigten Gesinnungsparagraphen ab , die `` staatsfeindliche Propaganda '' unter scharfe Strafen stellten . 
Regierung_s2736_f1	`` Ich glaube nicht '' , sagt Ercan Kanar , `` daß die Folter unter dieser Regierungkeywordtag ausgemerzt wird , wie man uns das verspricht . 
Regierung_s2951_f1	Im Gegensatz zum Protest von militärischer Seite ist die Entscheidung der Regierungkeywordtag in Brüssel bei keiner der politischen Parteien auf große prinzipielle Einwände gestoßen . 
Regierung_s3011_f1	Der Bonner Regierungssprecher Dieter Vogel sagte nach dem Treffen Kohls mit Bush in München , die beiden Regierungenkeywordtag legten besonderen Wert auf die Verpflichtung Jelzins , die russischen Haushaltsdefizite umgehend und deutlich abzubauen . 
Regierung_s3041_f1	Die beiden Parteien sind von der Regierungkeywordtag selbst gegründet und zu Beginn auch finanziert worden . 
Regierung_s3120_f1	Die britischekeywordtag Regierungkeywordtag versucht verzweifelt , das Projekt des Euro-Fighters `` Jäger 90 '' zu retten , aus dem die deutsche Bundesregierung auszusteigen plant . 
Regierung_s3128_f1	Rühe machte seinem Gastgeber klar , daß die Regierungkeywordtag Kohlkeywordtag eine Billigversion des `` Jäger 90 '' nicht für realistisch halte : 
Regierung_s3197_f2	Die Fragestunde , ursprünglich gedacht als ein parlamentarisches Instrument zur Kontrolle der Regierungkeywordtag , sei `` eine stumpfe Waffe geworden , weil die Regierungkeywordtag sich dumm stellt , Theater veranstaltet oder die Unwahrheit sagt '' . 
Regierung_s3203_f1	Bei geschickter Vorbereitung kann die Regierungkeywordtag dabei durchaus in Bedrängnis kommen . 
Regierung_s3245_f1	Die Regierungenkeywordtag der G-7-Länder setzen sich dafür ein , daß `` ihre '' Firmen durch Patenschaften in den Staaten der früheren UdSSR den direkten Transfer unternehmerischen Wissens verstärken . 
Regierung_s3307_f1	Französischekeywordtag Regierungkeywordtag will Straßenblockaden mit Gewalt brechen , doch die Proteste weiten sich aus 
Regierung_s3321_f1	Es sollte aber , nachdem die Pariserkeywordtag Regierungkeywordtag am Sonntag abend die gewaltsame Räumung von Straßensperren angeordnet hatte , noch bis in die frühen Morgenstunden dauern , bis die Fahrer und zahlreichen Schaulustige in den Genuß eines Spektakels ganz anderer Art kommen sollten . 
Regierung_s3334_f1	Die Entscheidung der Regierungkeywordtag , die Herausforderung der `` Routiers '' , wie die Fernfahrer in Frankreich heißen , mit einem Kraftakt zu beenden , war zum Schluß eines langen Wochenendes gefallen , in dessen Verlauf das Land immer mehr in Agonie zu verfallen schien . 
Regierung_s3344_f1	`` Die Regierungkeywordtag weicht nicht zurück '' , hatte ein sichtlich ratloser Premierminister Pierre Bérégovoy am Sonntag in mehreren Interviews erklärt . 
Regierung_s3348_f1	Als die ersten Blockaden entstanden , hatte die Regierungkeywordtag es mit strengen Warnungen versucht . 
Regierung_s3349_f1	Dann hatte es Diskussionen mit den Vertretern des Transportgwerbes und den Gewerkschaften der Fahrer gegeben , in denen die Regierungkeywordtag unter anderem zusagte , daß die Fahrtenschreiber nicht zur nachträglichen Sanktion von Geschwindigkeitsüberschreitungen herangezogen werden sollten . 
Regierung_s3352_f1	Sie verlangen von der Regierungkeywordtag nicht weniger , als die ersatzlose Rücknahme des vom Parlament beschlossenen und seit 1. Juli in Kraft getretenen Gesetzes über das neue Punktesystem . 
Regierung_s3356_f1	Die festgefahrene Situation mußte der Regierungkeywordtag umso auswegloser erscheinen , als sie auf der Seite der Lastwagenfahrer zwar lokale Wortführer wie Michel in Pahlempin und andere durch Fernsehinterviews zu nationaler Bekanntheit gelangte Sprecher hatte , aber keine repräsentativen Verhandlungsführer finden konnte . 
Regierung_s3366_f1	Ob die Regierungkeywordtag die gewaltsamen Räumungen fortsetzen würde , war zunächst nicht klar . 
Regierung_s3369_f1	Auch das engt den Bewegungsspielraum der Regierungkeywordtag ein . 
Regierung_s3547_f1	Rühe wiederum machte seinem Gastgeber klar , daß die Regierungkeywordtag Kohlkeywordtag eine Billigversion des `` Jäger 90 '' nicht für realistisch halte : 
Regierung_s3554_f1	Mit wieviel Blindheit muß eigentlich eine Regierungkeywordtag geschlagen sein , die eine Neuerung wie den Punkteführerschein ausgerechnet zum 1. Juli einführt ? 
Regierung_s3557_f1	Doch nun sitzt die Regierungkeywordtag mit ihrer Reform in der Klemme und weiß nicht mehr ein noch aus . 
Regierung_s3565_f1	Doch das gibt ihnen noch lange nicht das Recht , Regierungkeywordtag und Gesetzgeber in die Knie zwingen zu wollen . 
Regierung_s3606_f1	Die Regierungkeywordtag in Pyöngyang reagierte nicht unmittelbar auf das Schreiben . 
Regierung_s3616_f1	Zudem klagen die Moslems darüber , daß Waffenkäufe von im Ausland lebenden Bosniern von bosnisch-kroatischen Milizeinheiten beschlagnahmt würden , deren Treue zur Regierungkeywordtag in Sarajewo zweifelhaft sei . 
Regierung_s3623_f1	Falls die Militäraktion gelinge , könnte eine der vordringenden Einheiten innerhalb weniger Tage einen Korridor nach Sarajewo freikämpfen , glaubte Divjak , einer der wenigen Serben , die der bosnischenkeywordtag Regierungkeywordtag die Treue halten . 
Regierung_s3645_f1	Der britische UN-Botschafter Sir David Hannay verwies darauf , daß die irakischekeywordtag Regierungkeywordtag früher schon `` unter falschen Etiketten '' Produktionsstätten für Waffen verborgen habe . 
Regierung_s3692_f1	Der Vorsitzende der bei den Wahlen am 23. Juni siegreichen Arbeitspartei einigte sich mit Vertretern der orthodoxen Schas-Partei und der Vereinigten Thora-Partei über die Bedingungen für eine Beteiligung an der Regierungkeywordtag . 
Regierung_s3712_f1	Die serbischekeywordtag Regierungkeywordtag kündigte an , wegen der UN-Sanktionen wichtige Lebensmittel zu rationieren . 
Regierung_s3821_f1	Beim Umzug von Parlament und Regierungkeywordtag von Bonn nach Berlin sollen auf der Spree-Insel im Ost-Berliner Bezirk Mitte vier Bundesministerien angesiedelt werden , darunter das Innen- und das Außenressort . 
Regierung_s3838_f1	Die Regierungkeywordtag hatte 1991 bereits den Wehrdienst aus Kostengründen von 18 auf vier Monate ab 1993 verringert . 
Regierung_s3840_f1	Staatschef Soares argumentiert , daß die Regierungkeywordtag nicht einfach Gesetze mit früheren Laufbahnzusagen kurzfristig ändern könne . 
Regierung_s3939_f1	Die Truppen der Regierungkeywordtag Schewardnadsekeywordtag meldeten die Vertreibung der Rebellen aus der Stadt . 
Regierung_s3982_f1	Pariserkeywordtag Regierungkeywordtag handelte Kompromiß aus / 
Regierung_s3986_f1	Vertreter der Regierungkeywordtag sowie der Fahrer und ihrer Arbeitgeber hatten in der Nacht einen Kompromiß ausgehandelt , der die Folgen des Punktesystems für die Berufsfahrer mildern soll . 
Regierung_s4092_f1	Eine umfassende Neubildung der Regierungkeywordtag wird nicht erwartet . 
Regierung_s4094_f1	Matesa löst den bisherigen Ministerpräsidenten Nikica Valentic ab , der aus `` persönlichen Gründen '' aus der Regierungkeywordtag ausschied . 
Regierung_s4133_f1	Der US-Minister hatte bereits am Freitag zu erkennen gegeben , daß seine Regierungkeywordtag die Friedenstruppe notfalls auch ohne russische Beteiligung aufstellen werde . 
Regierung_s4157_f1	Regierungkeywordtag Cillerkeywordtag gewinnt die Vertrauensabstimmung 
Regierung_s4162_f1	Die Regierungkeywordtag wird jedoch nur knapp zwei Monate im Amt bleiben , weil für den 24. Dezember Parlamentswahlen angesetzt sind . 
Regierung_s4180_f1	`` Wenn wir eine atheistischekeywordtag Regierungkeywordtag wählen , werden wir von Dieben und Mafiosi , von einem Dickicht des Verbrechens heimgesucht . '' 
Regierung_s4224_f1	Die Menschenrechtsorganisation amnesty international hatte die sofortige Freilassung Saro-Wiwas und seiner ebenfalls zum Tode verurteilten acht Mitstreiter verlangt und den Shell-Konzern aufgefordert , seinen Einfluß bei der nigerianischenkeywordtag Regierungkeywordtag geltend zu machen . 
Regierung_s4342_f1	Seit der Staatsgründung hielt er immer Spitzenpositionen in Politik und Regierungkeywordtag . 
Regierung_s4422_f1	Ministerpräsident Viktor Tschernomyrdin scheiterte offenbar mit seinem Versuch , sich in der Regierungkeywordtag mehr Einfluß zu verschaffen . 
Regierung_s4440_f1	In dem jetzt in Genf vorgelegten Abschlußbericht einer dreiwöchigen Konferenz wurde die Regierungkeywordtag in Stockholm zu größeren Anstrengungen dagegen aufgefordert . 
Regierung_s4441_f1	Auch die Regierungkeywordtag in Estland wurde wegen einer Ausgrenzung der starken russischen Minderheit kritisiert . 
Regierung_s4543_f1	`` Diese Regierungkeywordtag , der ich die Ehre habe gemeinsam mit ( Außenminister ) Schimon Peres vorzustehen , hat sich entschlossen , dem Frieden eine Chance zu geben . 
Regierung_s4607_f1	Die Regierungenkeywordtag Ägyptens und Jordaniens , die Friedensverträge mit Israel abgeschlossen haben , äußerten sich schockiert . 
Regierung_s4651_f1	Die israelischekeywordtag Regierungkeywordtag will auch nach der Ermordung von Ministerpräsident Yitzhak Rabin dessen Friedenspolitik fortsetzen . 
Regierung_s4685_f1	Der Vorsitzende des oppositionellen Likud-Blocks , Benjamin Netanjahu , sagte im Fernsehen , seine Fraktion werde Peres unterstützen , da in einer Demokratie eine Regierungkeywordtag durch Wahlen `` und nicht durch Mord '' geändert werde . 
Regierung_s4746_f1	Kein Wunder , daß die Kaziken und die kleine Elite der Chamulas , dies zu Forderungen an die Regierungkeywordtag nutzen . 
Regierung_s5250_f1	Gegen Ende dieses Jahres gälte es , Bilanz zu ziehen - ob zusätzliche Arbeitsplätze und Ausbildungsplätze geschaffen wurden - und die Bereitschaft besteht , - zusätzliche Langzeitarbeitslose einzustellen , - ob die Regierungkeywordtag auf Verschlechterungen im Sozialbereich verzichtet hat - mit einem Wort , ob Bundesregierung und Metallarbeitgeber zu konkreten Vereinbarungen im Kampf gegen die Arbeitslosigkeit bereit sind . 
Regierung_s5251_f1	Über konkrete Schritte zur Verwirklichung dieses `` Bündnisses '' muß gesprochen werden , wenn Metallarbeitgeber und Regierungkeywordtag dazu prinzipiell bereit sind . 
Regierung_s5425_f1	Und die Mehrheit des israelischen Volkes vertraute ihm , fühlte sich unter seinerkeywordtag Regierungkeywordtag sicher . 
Regierung_s5432_f1	Schon vor 21 Jahren , als er zum ersten Mal das Amt des Ministerpräsidenten übernahm , betonte er in seiner Antrittsrede : `` Die erste Pflicht dieser Regierungkeywordtag ist , jeden vernünftigen Weg zum Frieden zu suchen . '' 
Regierung_s5458_f1	Als im April 1974 die Regierungkeywordtag Golda Meirs über die Folgen des Yom-Kippur-Krieges stürzte , wurde er der Nachfolger der `` großen , alten Dame '' . 
Regierung_s5459_f1	Im September 1984 trat er der `` Regierungkeywordtag der Nationalen Einheit '' als Verteidigungsminister bei , in der er für Israels weitgehenden Rückzug aus Libanon , aber auch für die Bombardierung des PLO-Hauptquartiers in Tunis ( 1985 ) verantwortlich zeichnete . 
Regierung_s5542_f1	In den vergangenen fünf Jahren warf er den Regierungenkeywordtag Knüppel zwischen die Beine , suchte immer wieder nach Vorwänden , um das Parlament aufzulösen und hielt enge Kontakte zu den Generalen . 
Regierung_s5724_f1	`` Die Regierungkeywordtag Israelskeywordtag gibt mit tiefer Trauer den Tod des Ministerpräsidenten und Verteidigungsministers Yitzhak Rabin bekannt , der heute von einem Attentäter in Tel Aviv ermordet wurde '' , teilte ein Regierungssprecher vor dem Krankenhaus Journalisten und ängstlich wartenden Israelis mit . 
Regierung_s5745_f1	Die Regierungkeywordtag durfte die Sicherheit nicht noch weiter vernachlässigen . '' 
Regierung_s5771_f1	Zwar beschuldigten sie die Mitglieder der Regierungkeywordtag unablässig , `` mit den Terroristen der PLO '' zu `` kollaborieren '' . 
Regierung_s5772_f1	Niemand aber , auch die meisten dieser radikalen Siedler nicht , glaubte oder ahnte , daß sich dieser Haß eines Tages im wirren Kopf eines Fanatikers auch gegen eigene Landsleute richten könnte , gegen Mitglieder der Regierungkeywordtag . 
Regierung_s5908_f1	Wer wie die Minderheit bei Pax Christi oder die Realpolitiker bei den Grünen um Joschka Fischer auf militärische Mittel als letzte Mittel zum Schutz von schutzlosen Menschen zu greifen bereit ist , gesteht nach Auffassung der Pax-Christi-Mehrheit einer Regierungkeywordtag unter den Voraussetzungen der allgemeinen Wehrpflicht `` das Recht zu , seine Bürger und eventuell auch Bürgerinnen zum Töten auszubilden und auf Befehl hin einzusetzen '' . 
Regierung_s6355_f1	PDS würde rot-grünekeywordtag Regierungkeywordtag tolerieren 
Regierung_s6423_f1	Die schwedischekeywordtag Regierungkeywordtag muß in Kürze entscheiden , ob bisher geheime Akten über Willy Brandts Aufenthalt im Land in der Zeit von 1940 bis 1945 freigegeben werden . 
Regierung_s6514_f1	Die bosnischekeywordtag Regierungkeywordtag beschloß nach Presseberichten , daß die Deutsche Mark neben dem Dinar weiterhin als Währung in Umlauf bleiben soll . 
Regierung_s6654_f1	Die irischekeywordtag Regierungkeywordtag hat am Montag vier republikanische Häftlinge freigelassen . 
Regierung_s6810_f1	Eine von der Europäischen Union schon vor Jahren verabschiedete Verordnung , die aber erst Anfang 1996 in Kraft tritt , treibt Kanadaskeywordtag Regierungkeywordtag und die Organisationen der Ureinwohner um : die Fallenfangverordnung , die den Import von Fellen dreizehn wildlebender Tierarten verbieten wird . 
Regierung_s6857_f1	Gruppen formieren sich nach Großinteressen , Mehrheiten stehen gegen Minderheiten , und die Regierungkeywordtag vollzieht , was nach der Balance der Kräfte möglich ist . 
Regierung_s7476_f2	Normalerweise lehnt die Opposition prinzipiell den Haushalt der Regierungkeywordtag ab , weil die Regierungkeywordtag ohnehin eine Mehrheit hat . 
Regierung_s7544_f1	Doch Berlin braucht gerade wegen der anstehenden schweren Aufgaben eine handlungsfähige Regierungkeywordtag . 
Regierung_s7562_f2	12. Demokratie lebt von einem konstruktiven Spannungsverhältnis zwischen Regierungkeywordtag und Opposition , wobei die Opposition immer zugleich auch potentiell die Regierungkeywordtag von morgen sein kann und muß . 
Regierung_s7575_f1	16. Wenn dennoch eine knappe Mehrheit der Berliner SPD aus sicherlich wohlmeinenden staatstragenden Gründen eine Neuauflage der großen Koalition gegen eine breite Minderheit durchsetzen würde , würde eine solche Regierungkeywordtag wiederum nur ertragen , aber nicht als eigenes Projekt `` bewußt angenommen '' werden . 
Regierung_s7586_f1	In der Regierungkeywordtag mit der CDU hat die SPD diese Chance nicht . 
Regierung_s7597_f1	Die chinesischekeywordtag Regierungkeywordtag ist sehr erfreut darüber , daß die Bundesregierung kurz vor dem Besuch von Bundeskanzler Helmut Kohl die militärische Zusammenarbeit wiederbelebt hat . 
Regierung_s7723_f1	Die dänischekeywordtag Regierungkeywordtag glaubt nun wieder fest daran , daß der frühere Außenminister Uffe Ellemann-Jensen Nato-Generalsekretär werden kann . 
Regierung_s7733_f1	Daß die holländischekeywordtag Regierungkeywordtag vergangenen Freitag Lubbers offiziell für den Nato-Spitzenposten nominierte , wird in Kopenhagen als Flucht nach vorne interpretiert . 
Regierung_s7740_f1	Die neue Entwicklung kommt jedoch auch für die dänischekeywordtag Regierungkeywordtag überraschend : 
Regierung_s7922_f1	Nach der Warnung der beiden Bundesbehörden hat die Regierungkeywordtag von Oberbayern schon reagiert . 
Regierung_s8009_f1	Doch auch die Bonnerkeywordtag Regierungkeywordtag hat ein Wörtchen mitzureden : 
Regierung_s8125_f1	Der georgische Präsident verfügt künftig nach US-Vorbild über starke Vollmachten und ist direkter Chef der Regierungkeywordtag . 
Regierung_s8329_f1	Die Bonnerkeywordtag Regierungkeywordtag und die deutsche Wirtschaft wollen die Handelsbeziehungen mit Lateinamerika ausbauen . 
Regierung_s8431_f1	Diese Erfahrung dürfte Ministerpräsident Reinhard Höppner teilen , der sich in Sachsen-Anhalt im Sommer 1994 mit der Bildung einer rot-grünenkeywordtag Regierungkeywordtag unter stiller Teilhabe der PDS auf ein politisches Experimentierfeld begab . 
Regierung_s8627_f1	Der UN-Sonderbeauftragte Gaspar Biro präsentierte der UN-Vollversammlung in New York einen Bericht , in dem er Regierungkeywordtag und paramilitärische Organisationen beschuldigt , Menschen zu versklaven , zu unterdrücken und brutal zu mißhandeln . 
Regierung_s8635_f1	Die Regierungkeywordtag habe ihre Ankündigung , die Rechte der Frauen zu stärken , nicht umgesetzt , heißt es in einem in London veröffentlichten Bericht . 
Regierung_s8683_f1	In einem Meer von roten Fahnen zogen in Moskau mindestens 10 000 Menschen zu Ehren des Revolutionärs Lenin durch die Straßen und schmähten die Regierungkeywordtag von Präsident Boris Jelzin . 
Regierung_s8966_f1	Konservativer Grinblats soll neue Regierungkeywordtag führen 
Regierung_s8968_f1	Der Vorsitzende der nationalkonservativen Partei `` Vaterland und Freiheit '' , Maris Grinblats , ist mit der Bildung einer neuen Regierungkeywordtag in Lettland beauftragt worden . 
Regierung_s8975_f1	Zur Bildung einer Regierungkeywordtag sind jedoch mindestens vier Parteien notwendig . 
Regierung_s8977_f1	Nach der lettischen Verfassung hat Grinblats allerdings kein Zeitlimit bei seinem Versuch , eine Regierungkeywordtag zusammenzustellen . 
Regierung_s9049_f1	Bremens Bürgermeister Henning Scherf ( SPD ) sagte , der freiwillige Gang der Berliner SPD in die Opposition sei ein `` Armutszeugnis '' , weil es bedeuten würde , daß sich die Partei `` nicht mehr traut , in der Regierungkeywordtag mitzugestalten '' . 
Regierung_s9067_f1	Verhandlungen zwischen Experten der sieben wichtigsten Industrienationen ( G-7 ) und der ukrainischenkeywordtag Regierungkeywordtag über die Stillegung des Atomkraftwerkes waren in der vergangenen Woche aus Geldgründen vorerst gescheitert . 
Regierung_s9076_f1	Premier Juppé bildet seinekeywordtag Regierungkeywordtag um 
Regierung_s9078_f1	In Frankreich hat Premierminister Alain Juppé nach nicht einmal sechs Monaten im Amt am Dienstag seinekeywordtag Regierungkeywordtag umgebildet . 
Regierung_s9089_f1	Zuvor hatte Juppé den Rücktritt der gesamten Regierungkeywordtag erklärt . 
Regierung_s9165_f1	Die Dokumente würden darlegen , daß die Regierungkeywordtag über die Exporte in den 80er Jahren informiert gewesen sei und nur so getan habe , als wisse sie von nichts . 
Regierung_s9242_f1	Und : Die wachsende Unsicherheit an den Ostgrenzen der Türkei ist vor allem durch deren Regierungkeywordtag und Parlament selbst verschuldet . 
Regierung_s9730_f1	Vor den Verhandlungen zwischen der niederländischenkeywordtag Regierungkeywordtag und Daimler-Benz über weitere Finanzspritzen für die Dasa-Tochter Fokker lassen beide Seiten die Säbel rasseln . 
Regierung_s9924_f1	Nachfolger Peres will Regierungkeywordtag ohne vorherige Neuwahlen bildenkeywordtag 
Regierung_s9938_f1	In Jerusalem wird davon ausgegangen , daß Staatspräsident Eser Weizman nach einer Trauerwoche wohl Peres , der auch das Amt des Verteidigungsministers von Rabin übernommen hat , mit der Bildung einer neuen Regierungkeywordtag beauftragen wird . 
Regierung_s9940_f1	Wenn er eine Mehrheit von 61 Mandaten im 120 Abgeordnete zählenden Parlament für sich gewinnen könne , werde er die neue Regierungkeywordtag dem Parlament vorstellen . 
Regierung_s9992_f1	Für die eingetrübte Stimmung macht der DIHT die Regierungkeywordtag mitverantwortlich : 
Regierung_s10007_f1	Deutlich zurückhaltender als Regierungkeywordtag und Institute beurteilt der DIHT die Rolle des privaten Konsums . 
Regierung_s10159_f1	Der britische Premierminister John Major hat widerstrebend eine Reform akzeptiert , die das Londoner Unterhaus gegen den Willen der Regierungkeywordtag und der meisten Tory-Abgeordneten beschlossen hat : 
Regierung_s10165_f1	Wiewohl die Abstimmung ohne Fraktionszwang stattfand , wird ihr Ausgang als erneute empfindliche Niederlage der konservativenkeywordtag Regierungkeywordtag gewertet . 
Regierung_s10282_f1	Außerdem beklagt die Kommission , daß von der Politik zwar häufig die `` Vorrangigkeit einer wirksamen Bekämpfung der Fluchtursachen beteuert '' werde , daß jedoch Zweifel angebracht seien , `` ob die Bundesregierung und andere Regierungenkeywordtag notwendige Schritte unternehmen , um Menschenrechtsverletzungen entgegenzuwirken und damit asylrelevante Fluchtgründe zu minimieren '' . 
Regierung_s10334_f1	Das auf Rushdie ausgesetzte Kopfgeld sei von einer privaten `` wohltätigen Institution '' in Iran , nicht von der Regierungkeywordtag , ausgesetzt worden . 
Regierung_s10489_f1	Regierungkeywordtag will Rechte des Kindes verbessern 
Regierung_s10539_f1	Die Führer der großen Oppositionsparteien schlossen mit der Regierungkeywordtag von Präsident Henri Konan Bédié ein Übereinkommen , das allen Gruppierungen die Teilnahme an den Parlamentswahlen am 26. November erlaubt . 
Regierung_s10542_f1	Charlotte Werleigh ist am Dienstag als erste Frau an die Spitze der Regierungkeywordtag Haitiskeywordtag gewählt worden . 
Regierung_s10565_f1	Soll man es nun eine Sensation nennen oder haben die recht , die , wie Michel Pericart , der Fraktionsvorsitzende der gaullistischen Regierungspartei RPR , völlig gelassen von der Umbildung der von Premierminister Alain Juppé geführten Regierungkeywordtag von Gaullisten und Mitte-Rechts-Parteien als der normalsten Angelegenheit der Welt sprachen ? 
Regierung_s10566_f1	Tatsache ist , daß die Nachricht von dem Rücktritt , den der Regierungschef am Dienstag morgen Präsident Jacques Chirac anbot , ebenso wie die postwendend mit dem Auftrag der Bildung einer neuen Regierungkeywordtag verbundene Wiederberufung Juppés durch den Staatschef für das politische Paris völlig unerwartet kam . 
Regierung_s10569_f1	Niemand hatte etwas von dem politischen Überraschungscoup geahnt , den der Premier und der Präsident während des Wochenendes eigentlich bereits für den Montag vorbereitet hatten , um die Regierungkeywordtag endlich aus ihrer desolaten Lage herauszuführen . 
Regierung_s10577_f1	Von dem im Frankreich der V. Republik in solchen Situationen bewährten Befreiungsschlag , der Entlassung des Premierministers als dem für alles Ungemach verantwortlichen Sündenbock und der Bildung einer neuen Regierungkeywordtag , hatte Chirac damals jedoch abgesehen . 
Regierung_s10579_f1	In seinem Fernsehauftritt vom 26. Oktober , in dem er mit der Verkündung des Vorrangs des Abbaus der Defizite in den öffentlichen Finanzen vor Maßnahmen zur Überwindung der sozialen Krise die längst fällige Klärung seines politischen Kurses vornahm , erneuerte Chirac dann sein Vertrauen in Juppé und wischte jeden Gedanken an eine Umbildung der Regierungkeywordtag vom Tisch . 
Regierung_s10580_f1	Daß Chirac es sich jetzt nach nur zehn Tagen anders überlegt hat und dem Drängen des Premierministers auf eine Umbildung der Regierungkeywordtag nachgab , darf als nachträglicher Triumph Juppés gelten . 
Regierung_s10585_f1	Die Folge war , daß Juppé mit 42 Ministern und Staatssekretären antreten mußte , zwölf mehr als die vorige Regierungkeywordtag unter Premierminister Edouard Balladur zählte . 
Regierung_s10589_f1	Der Ultra-Liberale Alain Madelin wurde dafür von Juppé aus der Regierungkeywordtag geworfen . 
Regierung_s10592_f1	Das entzog der Regierungkeywordtag , die sich zahlenmäßig auf eine überwältigende Mehrheit im Parlament stützen kann , einen wichtigen Teil ihrer Basis . 
Regierung_s10594_f1	Um die Regierungkeywordtag zu zwingen , zum Abbau der öffentlichen Defizite nicht nur Steuern und Abgaben zu erhöhen , sondern auch Ausgaben zu senken , wollen die Anhänger des früheren Premierministers die Etatansätze um zwei Milliarden Francs zusammenstreichen . 
Regierung_s10596_f1	Doch das Schlimmste steht der Regierungkeywordtag erst noch bevor , wenn in der kommenden Woche die Debatte über die Reform der defizitären Sozialversicherung beginnt . 
Regierung_s10696_f1	Daß Schwulen und Lesben nicht die Heirat im traditionellen Sinn ermöglicht werden soll , begründete die niedersächsischekeywordtag Regierungkeywordtag mit dem Verfassungsrecht . 
Regierung_s10735_f1	Jetzt werde ermittelt , ob dies als Gegenleistung für die Vergabe von Großaufträgen der Regierungkeywordtag geschah . 
Regierung_s10742_f1	Neun tamilische Parteien haben am Mittwoch die Regierungkeywordtag von Sri Lanka aufgefordert , einem Waffenstillstand mit den Rebellen der Befreiungstiger von Tamil Eelam ( LTTE ) zuzustimmen . 
Regierung_s10743_f1	Die Regierungkeywordtag solle ihre seit 23 Tagen andauernde Offensive auf der Halbinsel Jaffna einstellen . 
Regierung_s10745_f1	Die Parteien der tamilischen Minderheit , von denen zwei an der Regierungkeywordtag beteiligtkeywordtag sind , verglichen in ihrer Erklärung verglichen sie die Situation von mehr als 500 000 Flüchtlingen im Norden Sri Lankas mit dem Bürgerkrieg in Bosnien . 
Regierung_s10850_f1	Das kündigt die Regierungkeywordtag in Quito an . 
Regierung_s10946_f1	SPD-Spitzenkandidatin Ingrid Stahmer erklärte , die SPD könne eine aktive Politik nur innerhalb einer Regierungkeywordtag verwirklichen . 
Regierung_s11028_f1	Die 49jährige Soziologin ist in der Geschichte Haitis die erste Frau an der Spitze der Regierungkeywordtag . 
Regierung_s11235_f1	In der israelischenkeywordtag Regierungkeywordtag mehren sich Stimmen , die nach dem Mord an Rabin ein schärferes Vorgehen gegen Extremisten fordern . 
Regierung_s11265_f1	Die britischekeywordtag Regierungkeywordtag hat 24 Millionen Kondome vernichten lassen , die sie dem afrikanischen Simbabwe zur Aids-Vorsorge geschenkt hatte . 
Regierung_s11510_f1	Kürzlich warb er vor US-Wirtschaftsvertretern in Moskau , eine kommunistisch geführte Regierungkeywordtag sei auch gut für ausländische Investoren . 
Regierung_s11539_f1	Aber dann hat der Präsident zwei Möglichkeiten : die Regierungkeywordtag auszuwechseln oder das Parlament . 
Regierung_s11547_f1	Die Liste `` Jabloko '' von Anatoli Jawlinskij und Wladimir Lukin , die beinahe von der Wahl ausgeschlossen worden wäre , darf auf 14 Prozent hoffen , Jegor Gajdars Konkurrenz-Unternehmen bangt vor der Fünf-Prozent-Hürde , und Tschernomyrdins Wahlverein `` Unser Haus Rußland '' vollführt die schwierige Übung , als Wahlbewerber die Regierungkeywordtag zu kritisieren und sie als `` Machtpartei '' zugleich populär zu machen . 
Regierung_s11560_f1	Aber die dritte demokratische Wahl , seit zivilekeywordtag Regierungenkeywordtag vor zehn Jahren das Heft übernommen haben , ist eher von der Persönlichkeit der Kandidaten und folkloristischen Elementen denn strenger Rationalität geprägt . 
Regierung_s12461_f1	Die Regierungkeywordtag von Bosnien-Herzegowina hat in Anbetracht des voranschreitenden Friedensprozesses begonnen , den Wiederaufbau der von ihr kontrollierten Landesteile vorzubereiten . 
Regierung_s12513_f1	Die Regierungkeywordtag beschloß , eine Untersuchungskommission zu dem Anschlag einzusetzen . 
Regierung_s12543_f1	Die israelischekeywordtag Regierungkeywordtag setzt auf eine Politik getrennter Entwicklung : 
Regierung_s12569_f1	Die Regierungkeywordtag in Jerusalem möchte nicht abwarten , bis sich zu dem Software-Haus von alleine weitere Betriebe gesellen . 
Regierung_s12660_f1	Das künftige Verhalten der neuen kroatischenkeywordtag Regierungkeywordtag läßt sich nicht an ihrer Zusammensetzung ablesen , da Tudjman dabei auf Kontinuität , d. h. ein unverändertes Verhältnis zwischen Tauben und Falken bedacht war . 
Regierung_s12685_f1	`` Das habe ich früher schon geübt , nach Lösungen zu suchen , wenn meinekeywordtag Regierungkeywordtag nicht so will wie ich . '' 
Regierung_s12745_f1	Die Fehler , die zum Scheitern der ersten Regierungkeywordtag Juppékeywordtag geführt haben , sind ja nicht nur bei den Ministern und Staatssekretären zu suchen , die jetzt in die Wüste geschickt wurden , sondern auch bei Juppé selbst , der sich nicht durchzusetzen vermochte . 
Regierung_s12746_f1	Verantwortung trifft aber auch Chirac , der , anders als er es im Wahlkampf verhieß , sich nicht damit begnügte , die großen Linien festzulegen und der Regierungkeywordtag die Führung der Politik zu überlassen , sondern alle wichtigen Entscheidungen im Elysée-Palast selbst traf , ohne daß eindeutige Orientierungen zu erkennen gewesen wären . 
Regierung_s12762_f1	Es wäre die erste erfolgreiche Anwendung dieses neuen Verfahrens , das die Ausarbeitung eines europäischen Gesetzes Gewerkschaften und Arbeitgebern überläßt , während sonst die nationalenkeywordtag Regierungenkeywordtag den Ton angeben . 
Regierung_s12832_f1	Zum Schritt des IG-Metall-Vorsitzenden Klaus Zwickel , der Unternehmern und Regierungkeywordtag ein `` Bündnis für Arbeit '' angeboten hat , sagte Kanzler Kohl am Mittwoch im Bundestag : `` Wir werden dieses Angebot aufnehmen und darüber sprechen . '' 
Regierung_s12846_f1	Die Regierungkeywordtag weigere sich konstant , eine aktive Arbeitsmarktpolitik zu betreiben , kritisierte der Bündnisgrüne . 
Regierung_s12997_f1	Regierungkeywordtag und Opposition liefern sich einen etwas anderen Wettkampf . 
Regierung_s13104_f1	Die syrischekeywordtag Regierungkeywordtag will die Verhandlungen über einen Frieden im Nahen Osten `` beschleunigen '' . 
Regierung_s13179_f1	Die deutschekeywordtag Regierungkeywordtag habe alle erforderlichen Fragen für eine Auslieferung zur Zufriedenheit beantwortet , hatte der Richter in seiner Begründung gesagt . 
Regierung_s13196_f1	Während die neuseeländischekeywordtag Regierungkeywordtag als Gastgeberin am Donnerstag noch um Schadensbegrenzung bemüht war , verlangte Australien `` eine klare Verurteilung '' der Atomwaffenversuche . 
Regierung_s13336_f1	Der Geschäftsträger der haitianischen Botschaft in Bogota , Frantz Romulus , sagte , die haitianischekeywordtag Regierungkeywordtag werde Avril `` schwerlich '' nach Kolumbien ausreisen lassen . 
Regierung_s13360_f1	Der Generalsekretär des Commonwealth , der ehemalige nigerianische Außenminister Chief Emeka Anyaoku , erklärte in einer schriftlichen Stellungnahme : `` Ich wiederhole meine von Herzen kommende Bitte , daß die nigerianischekeywordtag Regierungkeywordtag Gnade walten läßt . '' 
Regierung_s13361_f1	Auch die Regierungkeywordtag der USA schloß sich dem Gnadengesuch an . 
Regierung_s13362_f1	Nigeriaskeywordtag Regierungkeywordtag des afrikanischen Staates hatte noch am Mittwoch die Todesurteile bestätigt . 
Regierung_s13367_f1	Auch der niederländisch-britische Ölkonzern Royal Dutch / Shell bat die nigerianischekeywordtag Regierungkeywordtag um `` Milde '' für Ken Saro-Wiwa . 
Regierung_s13395_f1	Die deutschekeywordtag Regierungkeywordtag habe alle erforderlichen Fragen für eine Auslieferung zur Zufriedenheit beantwortet . 
Regierung_s13448_f1	Die Bonnerkeywordtag Regierungkeywordtag sprach sich gegen die Richtlinie aus . 
Regierung_s13563_f1	Auch die britischekeywordtag Regierungkeywordtag hatte in der vergangenen Woche erklärt , sie bleibe bei ihrem Einreiseverbot für Mun . 
Regierung_s13720_f1	Die Regierungkeywordtag verfahre nach dem Motto `` Haushaltslöcher stopfen und die Gesellschaft spalten '' , sagte Schreiner weiter . 
Regierung_s14102_f1	Die Menschenrechtsorganisation amnesty international klagt in ihrem Bericht vom Monatsbeginn die Regierungkeywordtag in Tunis an , internationales sowie selbst tunesisches Recht zu mißachten . 
Regierung_s14114_f1	Mourali wurde im Mai wegen `` Mitgliedschaft von En Nahda '' zu drei Jahren und Ben Gharbia wegen Teilnahme an einer Kundgebung in Deutschland gegen Tunesienskeywordtag Regierungkeywordtag zu 14 Monaten Gefängnis verurteilt . 
Regierung_s14120_f1	1994 teilte die Regierungkeywordtag in den Parlamentswahlen der bürgerlichen , sozial-liberal orientierten MDS zehn von 163 Abgeordnetensitzen zu , um eine politische `` Öffnung '' anzuzeigen . 
Regierung_s14197_f1	Die Regierungkeywordtag von Südaustralien und der EDS-Konzern haben einen Neun-Jahres-Vertrag über Informationstechnik-Dienstleistungen abgeschlossen . 
Regierung_s14220_f1	Man spürt : Die Gegenseite , neben Shell die britischekeywordtag Regierungkeywordtag , die das Versenken der Brent Spar als `` ökologisch beste Variante '' genehmigte , hat sich vom Schock erholt und die Argumente pro Versenkung wiederaufgearbeitet . 
Regierung_s14239_f1	Warum also die ganze Brent Spar -Aufregung speziell in der deutschen Volksseele , fragt Eggar , wenn die deutschekeywordtag Regierungkeywordtag es nicht einmal schafft , ihrem größten Fluß die Ökoschweinereien abzugewöhnen ? 
Regierung_s14273_f1	`` Wir waren halt so verzweifelt , daß wir jedes denkbare Argument nutzten , um bei der britischenkeywordtag Regierungkeywordtag überhaupt etwas zu erreichen . '' 
Regierung_s14349_f1	Die jüngste Entscheidung der britischenkeywordtag Regierungkeywordtag , trotz der weltweiten Proteste gegen die französischen Atomversuche im Südpazifik das Atomtestprogramm des französischen Präsidenten Jacques Chirac zu billigen und zu unterstützen , hat die Anrainerländer des Südpazifiks fast ebenso stark erschüttert , wie die Atomexplosionen im brüchigen Basalt-Sockel der Koralleninsel Mururoa selbst . 
Regierung_s14352_f1	Die Regierungkeywordtag des früheren britischen Protektorats Salomoninseln , heute noch eine Monarchie mit Königin Elizabeth II. als nominellem Staatsoberhaupt an der Spitze , hat sogar wegen des `` Verrats von Premierminister Major '' die Ausrufung einer Republik angekündigt . 
Regierung_s14358_f2	Die Entscheidung der britischenkeywordtag Regierungkeywordtag , sich in der Frage der Kernwaffenversuche auf die Seite Chiracs zu stellen , wird von den Regierungenkeywordtag der südpazifischen Region als Fehler angesehen . 
Regierung_s14573_f1	Dort sollen auch Aufbau und Entscheidungsverfahren der größer gewordenen Union auf dem Prüfstand stehen - allerdings ist vorrangig an den Prozeß unter den Regierungenkeywordtag gedacht . 
Regierung_s14623_f1	Bundestagspräsidentin Rita Süssmuth äußert sich bereit , die Europäische Kommission zu eigenen Initiativen zu ermächtigen , damit sich gegenüber der Zusammenarbeit zwischen Regierungenkeywordtag mehr `` supranationale Interessenbestimmung '' durchsetzt . 
Regierung_s14820_f1	Regierungkeywordtag verteilt Trostpflaster an die Arbeiter , die 1968 den Schrott eines abgestürzten US-Atombombers wegräumten 
Regierung_s14822_f1	Mit einem Trostpflaster von 50 000 Kronen , umgerechnet rund 13 000 Mark , entschädigt die dänischekeywordtag Regierungkeywordtag nun 1650 Arbeiter für ein Leben in Angst . 
Regierung_s14825_f1	Obwohl die Regierungkeywordtag dies nicht für erwiesen ansieht , bewilligte sie nun eine Entschädigung von insgesamt 85 Millionen Kronen für die `` psychischen Belastungen '' , denen die Arbeiter seither ausgesetzt waren . 
Regierung_s14839_f1	Erst als im Sommer dieses Jahres die dänischekeywordtag Regierungkeywordtag einräumte , daß atombewaffnete US-Bomber in jenen Jahren - im Widerstreit zur offiziellen Politik - regelmäßig Grönland anflogen , erkannte Ministerpräsident Poul Nyrup Rasmussen auch eine Verantwortung des Staats gegenüber den Thule-Arbeitern an . 
Regierung_s14841_f1	Statt dessen gestand ihnen die Regierungkeywordtag eine Entschädigung zu : 
Regierung_s15020_f1	SPD-Wirtschaftssprecher Ernst Schwanhold warf der Regierungkeywordtag vor , `` das Volk belogen '' zu haben mit der Behauptung , zwei bis drei Prozent Wachstum reichten für neue Arbeitsplätze aus . 
Regierung_s15199_f1	Für FDP-Wirtschaftsminister Günter Rexrodt war im Rollenspiel der Regierungkeywordtag wohl der Part des `` Schurken '' vorgesehen , die nächste Runde im Sozialabbau anzukündigen . 
Regierung_s15394_f1	Gleichzeitig folgte Shell International aber der nigerianischenkeywordtag Regierungkeywordtag darin , Saro-Wiwa und seine Mosop-Bewegung `` gewalttätiger Aktivitäten '' zu bezichtigen ; 
Regierung_s15396_f1	`` Den uns zugeschriebenen Einfluß ( auf die Regierungkeywordtag Nigeriaskeywordtag - FR ) zu nutzen '' , hieß es noch am 2. November aus London , `` das wäre gefährlich und falsch '' . 
Regierung_s15571_f1	Der Rat der Siedler im Westjordanland kündigte an , seine Proteste gegen die Politik der israelischenkeywordtag Regierungkeywordtag zu mäßigen und Extremisten aus den eigenen Reihen auszuschließen . 
Regierung_s16001_f1	Auch der belgische Verteidigungsminister Jean-Pol Poncelet räumte am Donnerstag ein , daß seine Regierungkeywordtag in Brüssel seit Januar 1994 durch den belgischen Geheimdienst von den Vorbereitungen des Völkermordes unterrichtet gewesen sei . 
Regierung_s16144_f1	Auf Druck der USA hat die niederländischekeywordtag Regierungkeywordtag die Kandidatur des ehemaligen Ministerpräsidenten Ruud Lubbers für das Amt des Nato-Generalsekretärs zurückgezogen . 
Regierung_s16200_f1	Nach dem Repräsentantenhaus stimmte auch der Senat einer von der Regierungkeywordtag geforderten Übergangsregelung zu , mit der die Obergrenze für die Staatsverschuldung um 67 Milliarden auf knapp fünf Billionen Dollar erhöht wird . 
Regierung_s16212_f1	Die Regierungkeywordtag werde nicht akzeptieren , daß 800 000 Staatsbediensteten die Entlassung drohe . 
Regierung_s16221_f1	Die übrigen 51 Commonwealth-Mitglieder wollen einen dringenden Gnadenappell für die neun Bürgerrechtler an die Regierungkeywordtag in Abuja richten . 
Regierung_s16258_f1	Der Hauptverband des Deutschen Einzelhandels ( HDE ) ist weiter gegen Pläne der Regierungkeywordtag zur Ausweitung der Ladenöffnungszeiten , hofft aber auf einen für die Geschäfte hinnehmbaren Kompromiß . 
Regierung_s16317_f1	Truppenbewegungen in Kroatien haben bei der UN-Friedenstruppe Befürchtungen ausgelöst , daß die Regierungkeywordtag in Zagreb die Rückeroberung Ostslawoniens von den Serben plant . 
Regierung_s16712_f1	Das Fischerstädtchen hat seinen Kolonialcharakter unverfälscht in die Gegenwart herübergerettet : die aus groben Basaltsteinen gemauerten Häuschen der ehemaligen Walfänger , die Holzhäuser mit umlaufenden Veranden , die viktorianischen 	Regierungs- 	und Verwaltungsgebäude , die düsteren Festungskirchen , Hotels aus dem vorigen Jahrhundert wie das Star West und The Caledonian Inn , deren nostalgische Fassaden die Plastikkultur hinter den Schwingtüren verbergen . 
Regierung_s17155_f1	Im Interview der Frankfurter Rundschau gab Schröder einen Maßstab an : die Regierungkeywordtag Clintonkeywordtag . 
Regierung_s17163_f1	`` Wie Politik hilft , kann man an den USA studieren , da macht es die Regierungkeywordtag Clintonkeywordtag mit ihrer ungeheuren Macht , sich für ökonomische Interessen einzusetzen . '' 
Regierung_s17164_f1	Wie sieht das Mitglied der Regierungkeywordtag Clintonkeywordtag , der amerikanische Arbeitsminister und Professor der Volkswirtschaftslehre Robert B. Reich dieselbe Wirklichkeit ? 
Regierung_s17177_f1	Fällt er auf die deutschen Manager globaler Netze genauso herein wie die Regierungkeywordtag Bushkeywordtag vor ein paar Jahren auf die amerikanischen Manager globaler Netze ? 
Regierung_s17191_f1	So befindet sich Schröder bereits bei der Sichtweise von Globalisierung , Nationalökonomie und nationalen Unternehmen im Modernitätsrückstand gegenüber der von ihm gepriesenen amerikanischenkeywordtag Regierungkeywordtag . 
Regierung_s17243_f1	Ein halbes Jahr lang leugnen Regierungkeywordtag und Behörden die Verhaftung : 
Regierung_s17248_f1	Einmalig an dem Fall Dagli sei , `` daß Behörden und Regierungkeywordtag erstmals beim Verschwindenlassen der Lüge überführt werden konnten '' , sagt Ofteringer . 
Regierung_s17634_f1	1. Gibt es Unterschiede in den wirtschaftspolitischen Zielen der SPD im Vergleich zu denen der konservativ-liberalenkeywordtag Regierungkeywordtag ? 
Regierung_s18009_f1	In Nigeria plant der niederländisch-britische Erdölkonzern Shell mit der Regierungkeywordtag und anderen Konzernen eine Erdgas-Pipeline quer durch das Ogoniland . 
Regierung_s18016_f1	Wegen der zunehmenden Proteste gegen seine Präsenz hatte Shell die Regierungkeywordtag um Schutz gebeten . 
Regierung_s18304_f1	Zwischen 1988 und 1990 war Peres Finanzminister in Schamirskeywordtag neuer Regierungkeywordtag , kündigte dann jedoch die Koalition auf und ging in die Opposition . 
Regierung_s18598_f1	Dem Ehrgeiz Amazoninos , der im Wahlkampf 2000 Kettensägen an seine Sympathisanten verteilen ließ , könnte die Regierungkeywordtag bald einen Strich durch die Rechnung machen . 
Regierung_s18642_f1	Die übrigen 51 Commonwealth-Mitglieder wollen einen dringenden Gnadenappell für die neun Bürgerrechtler an die Regierungkeywordtag in Abuja richten . 
Regierung_s18690_f1	Die konservativ-wirtschaftsliberalekeywordtag Regierungkeywordtag macht gerade einen umwälzenden Ernüchterungsprozeß durch und nimmt Abschied von dieser Art `` Sozialdemokratisierung '' der Wirtschaftspolitik . 
Regierung_s18721_f1	Die Regierungkeywordtag in Madrid will jedoch auf der sicheren Seite sein . 
Regierung_s18774_f1	Die sozialistische Europaabgeordnete Pauline Green erklärte , die Preisverleihung sei `` ein unmißverständliches Signal an die Regierungkeywordtag in Ankara '' . 
Regierung_s18909_f1	Die türkischekeywordtag Regierungkeywordtag hat die Verleihung des vom Europaparlament vergebenen Sacharow-Preises an die inhaftierte kurdische Politikerin Leyla Zana scharf kritisiert . 
Regierung_s18922_f1	Die sozialistische Euro-Abgeordnete Pauline Green erklärte , die Preisverleihung sei `` ein klares und unmißverständliches Signal an die Regierungkeywordtag in Ankara '' . 
Regierung_s18956_f1	Eine spätere Rückkehr in die Regierungkeywordtag schloß Sahlin nicht aus . 
Regierung_s19067_f1	Darüber hinaus sicherte der Bundeskanzler dem öffentlichen Dienst zu , daß die Regierungkeywordtag `` keine Kahlschlag-Privatisierung '' beabsichtige . 
Regierung_s19165_f1	Dieses Geld soll eine Abgeltung der Regierungkeywordtag von Kuwait an den König für die Hilfe Spaniens im Golfkrieg von 1991 gewesen sein . 
Regierung_s19181_f1	Die Gesellschaft für bedrohte Völker warf der Regierungkeywordtag Opportunismus vor , bei ihr gingen Wirtschafts- und Militärbeziehungen vor . 
Regierung_s19241_f1	Da wußte er noch nicht , daß am Freitag bei der Abstimmung im Bundestag über die Einladung an den iranischen Außenminister Ali Akbar Welayati Abgeordnete aus beiden Koalitionsfraktionen ausscheren und der Regierungkeywordtag die erste Abstimmungsniederlage seit der Bundestagwahl zufügen würden . 
Regierung_s19300_f1	Während die Regierungkeywordtag in Den Haag freudig erklärte , nun sei ihr Mann offizieller Kandidat , ließ die Führungsmacht wissen , dieser habe `` bei uns niemanden beeindruckt '' . 
Regierung_s19342_f1	Der Beschluß ist die erste Niederlage der Regierungkeywordtag in dieser Legislaturperiode . 
Regierung_s19349_f1	Die Unionsfraktion hatte in einem eigenen Antrag nur verlangt , daß Iranskeywordtag Regierungkeywordtag die Rechtfertigung des Mordes vor der Konferenz zurücknehmen müsse . 
Regierung_s19433_f1	Das entschiedene Vorgehen der Regierungkeywordtag zeige , `` wie sehr sie sich den Interessen der ländlichen Oligarchie , der Großgrundbesitzer , Holzfirmen , Bergwerksunternehmen und der konservativen Interessengruppe im Nationalkongreß verpflichtet fühlt '' . 
Regierung_s19435_f1	Die Regierungkeywordtag Cardosokeywordtag verbünde sich `` mit den reaktionärsten und indianerfeindlichsten Gruppen im nationalen politischen Spektrum '' . 
Regierung_s19707_f1	Einzig der spanische Botschafter , dessen Land derzeit EU-Ratsvorsitzender ist , soll noch auf Posten bleiben und der nigerianischenkeywordtag Regierungkeywordtag den Protest der Europäer gegen die Menschenrechtsverletzungen übermitteln . 
Regierung_s19757_f1	Die Arbeitsgemeinschaft der Verbraucherverbände ( AGV ) wirft Politikern und Regierungenkeywordtag schwere Versäumnisse bei der bürgernahen Ausgestaltung der von 1999 an geplanten gemeinsamen Währung vor . 
Regierung_s19842_f1	Die Unterzeichner forderten die Weltöffentlichtkeit auf , Druck auf die srilankischekeywordtag Regierungkeywordtag auszuüben , damit die Flüchtlinge in ihre Häuser zurückkehren könnten . 
Regierung_s19848_f1	Daraufhin unterzeichnete auch die Regierungkeywordtag in Zagreb das Abkommen , das eine Übergangszeit von bis zu zwei Jahren vorsieht . 
Regierung_s19852_f1	Für die Regierungkeywordtag unterzeichnete der enge Vertraute von Präsident Franjo Tudjman , Hrvoje Sarinic , das Ostslawonien-Abkommen , das Stoltenberg und der US-Botschafter Peter Galbraith vermittelt hatten . 
Regierung_s20191_f1	Gebremst wird der Enthusiasmus der Bonnerkeywordtag Regierungkeywordtag - mit Kohl reisen die Minister Günter Rexrodt ( Wirtschaft ) , Wolfgang Bötsch ( Post ) und Jürgen Rüttgers ( Forschung ) - durch die im Reich der Mitte ansässigen Manager . 
Regierung_s20308_f1	Die Regierungkeywordtag Kohlkeywordtag deutet hinter den Kulissen an , sie handle dabei im Interesse des deutschen Steuerzahlers . 
Regierung_s20376_f1	Das entschiedene Vorgehen der Regierungkeywordtag zeige , `` wie sehr sie sich den Interessen der ländlichen Oligarchie , der Großgrundbesitzer , Holzfirmen , Bergwerksunternehmen und der konservativen Interessengruppe im Nationalkongreß verpflichtet fühlt '' . 
Regierung_s20378_f1	Cimi sprach in diesem Zusammenhang von einem Bündnis der Regierungkeywordtag mit den `` reaktionärsten und indianerfeindlichsten Gruppen '' . 
Regierung_s20407_f1	`` Eigentlich ist es nur noch möglich , aus dem Weltraum einzureisen , aber auch da wird sich die Regierungkeywordtag noch was einfallen lassen . '' 
Regierung_s20413_f1	Und ab Mittwoch wird die Regierungkeywordtag - theoretisch - nicht mehr in der Lage sein , die fälligen Zinsen auf die Staatsschulden zu zahlen . 
Regierung_s20415_f1	Am Freitag hatten das Abgeordnetenhaus und der Senat zwar zwei Gesetze über die Staatsausgaben und die Staatsverschuldung beschlossen , die die Regierungkeywordtag vorerst flüssig gehalten hätten . 
Regierung_s20419_f1	Nach amerikanischem Recht geht der Regierungkeywordtag das Geld aus , wenn zum 1. Oktober des jeweiligen Jahres kein neuer Haushalt vorliegt , der von Abgeordnetenhaus , Senat und Präsident beschlossen ist . 
Regierung_s20429_f1	Der normale Amerikaner wird im übrigen nicht sehr viel von der Teilschließung der Regierungkeywordtag merken : 
Regierung_s20435_f1	`` Türkische Republik '' vorerst ohnekeywordtag Regierungkeywordtag 
Regierung_s20437_f1	Die Regierungkeywordtag der nur von Ankara völkerrechtlich anerkannten `` Türkischen Republik Nordzypern '' ist am Samstag zurückgetreten . 
Regierung_s20438_f1	Ministerpräsident Hakki Atun von der konservativen Demokratischen Partei ( DP ) machte seinen Koalitionspartner , Vizepremier Özker Özgür , für das Scheitern der Regierungkeywordtag verantwortlich . 
Regierung_s20518_f1	Spontane , mitunter gewalttätige Proteste und Demonstrationen gegen die Öl-Multis und die Regierungkeywordtag sind in der Vergangenheit immer wieder blutig niedergeschlagen worden . 
Regierung_s20582_f1	Arbeitsminister Jin Nyum verkündete deshalb bereits vor einigen Tagen , die Regierungkeywordtag werde den neuen Verband auf keinen Fall anerkennen . 
Regierung_s20591_f1	Die Regierungkeywordtag geht mit harten Bandagen gegen den neuen Gewerkschaftsbund vor . 
Regierung_s20781_f1	Vier Milliarden Dollar - die britischekeywordtag Regierungkeywordtag wird sich diesem Geschäft nicht wegen neun Hinrichtungen in den Weg stellen wollen . 
Regierung_s20845_f1	Die kroatischekeywordtag Regierungkeywordtag hatte zuletzt auf höchstens einem Jahr bestanden . 
Regierung_s21046_f1	Das am Sonntag überraschend von den kroatischen Serben und der Regierungkeywordtag in Zagreb unterzeichnete Ostslawonien-Abkommen sieht im Grundsatz die Rückkehr dieser Region im Osten Kroatiens unter die kroatische Staatsgewalt vor . 
Regierung_s21066_f1	( ... ) 13. Die Regierungkeywordtag Kroatienskeywordtag wird mit der Übergangsverwaltung sowie den internationalen Streitkräften in vollem Umfang zusammenarbeiten . 
Regierung_s21067_f1	Während der Übergangszeit gestattet die kroatischekeywordtag Regierungkeywordtag internationalen Beobachtern die Anwesenheit entlang der internationalen Grenzen in der Region . 
Regierung_s21080_f1	Für rund 30 Milliarden US-Dollar solle die Strecke von Alma Ata nach Bandar Abbas durchgehend befahrbar gemacht werden , vereinbarten die Regierungenkeywordtag . 
Regierung_s21212_f1	Im Wirtschaftsleitantrag des saarländischen Ministerpräsidenten Oskar Lafontaine appelliere die SPD aber nur noch an die Wirtschaft , wie es die Regierungkeywordtag seit Jahren tue . 
Regierung_s21246_f1	Nachdem bekanntgeworden war , daß Frankreichskeywordtag Regierungkeywordtag die Ablehnung des Dänen offiziell mit dessen mangelhaften Kenntnissen der zweiten offiziellen Nato-Sprache neben Englisch begründet , waren Ellemann-Jensen mehrere Angebote von Sprachschulen zugesandt worden . 
Regierung_s21342_f1	Die Serben in Ostslawonien und die kroatischekeywordtag Regierungkeywordtag hatten am Sonntag vereinbart , das serbisch kontrollierte Ostslawonien friedlich in die kroatische Staatsordnung zurückzuführen . 
Regierung_s21356_f1	Wie Sprecher der SPD-geführtenkeywordtag Regierungenkeywordtag in Nordrhein-Westfalen , Hessen , Schleswig-Holstein , Hamburg und dem Saarland erklärten , sollen bis auf weiteres nigerianische Asylsuchende nicht mehr gezwungen werden , die Bundesrepublik zu verlassen . 
Regierung_s21445_f1	Regierungkeywordtag will Indianern mehr Rechte garantieren 
Regierung_s21447_f1	Die mexikanischekeywordtag Regierungkeywordtag wollte bei der seit Montag laufenden neuen Gesprächsrunde mit den Rebellen des Zapatistischen Nationalen Befreiungsheeres ( EZLN ) Verfassungsreformen zur Garantie der Rechte der Indianer vorschlagen . 
Regierung_s21583_f1	Sollten sich Kongreß und Regierungkeywordtag bis Mittwoch nicht geeinigt haben , droht die Zahlungsunfähigkeit , was auf dem amerikanischen Bond-Markt kräftige Kurseinbußen zur Folge haben könnte . 
Regierung_s21787_f1	Denn als Sahlin , die nach den höchsten Ämtern in Partei und Regierungkeywordtag strebte , wegen des Mißbrauchs staatlicher Kreditkarten für private Zwecke zur Rechenschaft gezogen wurde , nutzte sie ihren hektischen Alltag als Politikerin und Mutter von drei Kindern wirkungsvoll zu ihrer Verteidigung : 
Regierung_s22244_f1	Die Regierungkeywordtag sollte auf die Kürzung von Arbeitslosengeld und -hilfe verzichten und eine Regelung für ein größeres Ausbildungsplatzangebot finden . 
Regierung_s22294_f1	Äußerungen über `` koloniale Großtaten '' Japans empörten Regierungkeywordtag in Seoul 
Regierung_s22304_f1	Doch Außenminister Kono mußte eine geplante Reise nach Seoul absagen , weil ihn die südkoreanischekeywordtag Regierungkeywordtag nicht empfangen wollte . 
Regierung_s22306_f1	Die südkoreanischekeywordtag Regierungkeywordtag forderte den Rücktritt Etos , sonst könne das für kommenden Samstag geplante Gipfeltreffen zwischen Präsident Kim Young Sam und seinem japanischen Amtskollegen Tomiichi Murayama nicht stattfinden . 
Regierung_s22307_f1	Nachdem der Minister seinen Rücktritt eingereicht hatte , verkündete die südkoreanischekeywordtag Regierungkeywordtag , nun stehe dem Treffen der beiden Staatschefs auf der Konferenz der Asiatisch-Pazifischen Wirtschaftkooperation ( Apec ) in Osaka nichts mehr im Wege . 
Regierung_s22570_f1	Ella Poljakowa , die als Vertreterin der `` Soldatenmütter '' im Juli in Genf vor der UN-Menschenrechtskommission die geschönte Bilanz der Regierungkeywordtag rügte , rückt jetzt die Steuerfahndung auf den Leib ; 
Regierung_s22687_f1	Beide Regierungenkeywordtag unterzeichneten auch vier Abkommen zur Gründung eines `` Dialogforums für Hochtechnologie '' , über bilaterale Studien der chinesischen Infrastrukturentwicklung , über Export- und Importverträge und naturwissenschaftliche Forschungen . 
Regierung_s22905_f1	Die türkischekeywordtag Regierungkeywordtag hat einer Parlamentarier-Delegation aus Nordrhein-Westfalen die Einreise in die Türkei mit der Begründung verweigert , die Reise sei für die beiderseitigen Beziehungen `` nicht förderlich '' . 
Regierung_s22915_f1	Innenminister Franz-Josef Kniola ( SPD ) versicherte am Montag , daß die Regierungkeywordtag `` grundsätzlich '' an der Reise festhalte . 
Regierung_s23018_f1	Und Regierungenkeywordtag wie die britische , die in Sachen Brent Spar Shell bedingungslose Rückendeckung anbot , finden es schwer , in dieser neuen Krise den Öl-Magnaten die nervöse Hand zu halten . 
Regierung_s23031_f1	`` Sie dürfen davon ausgehen , daß die britischekeywordtag Regierungkeywordtag sich mit Shell in Verbindung setzen wird , um diese Pläne zu diskutieren . '' 
Regierung_s23054_f1	Sollten aber die angesprochenen Regierungenkeywordtag nicht willig sein , sich selbst den Ölhahn in Nigeria abzudrehen , wollen die in dieser Woche auf der Insel sich sammelnden Gegner des nigerianischen Regimes - afrikanische Demokraten , Bürgerrechtler , Umweltschützer - eine neue Graswurzelrebellion , à la Brent Spar , entfesseln . 
Regierung_s23068_f1	`` Daß die Regierungkeywordtag in Nigeria aus ihrer Verantwortung entlassen wird '' . 
Regierung_s23069_f1	Es sei deshalb in erster Linie Sache der Regierungenkeywordtag , ihren Worten auch Taten folgen zu lassen . 
Regierung_s23084_f1	Als Außenminister und Vizekanzler , als wichtigster Vertreter des kleineren Partners in der Regierungkeywordtag tritt man aber nicht in des Bundeskanzlers Abwesenheit zurück , und vom Ausland aus schon gar nicht . 
Regierung_s23094_f1	Denn : `` Ich werde mich nachdrücklich dafür einsetzen , daß dem entsprochen wird , was der Antrag der Koalitionsfraktion wünscht '' , habe er - nachzulesen im Bundestagsprotokoll - gesagt und hinzugesetzt : `` Lassen Sie uns die Reaktion abwarten , die iranischekeywordtag Regierungkeywordtag soll die Chance einer Korrektur haben . '' 
Regierung_s23302_f1	Grüne und DGB warfen der Regierungkeywordtag eine Politik des Sozialabbaus vor . 
Regierung_s23324_f1	Es sei noch zu früh , um abschließend zu beurteilen , ob der Anschlag den USA oder der Regierungkeywordtag Saudi-Arabienskeywordtag gegolten habe , sagte ein Sprecher des US-Verteidigungsministeriums . 
Regierung_s23374_f1	Unterdessen hat die Regierungkeywordtag von Nigeria den Prozeß gegen Saro-Wiwa erneut als `` fair und offen '' verteidigt . 
Regierung_s23417_f1	Da der zwischen Kongress und Clinton umkämpfte Gesamthaushalt für das kommende Jahr umstritten ist , muß die Regierungkeywordtag für ihre laufenden Kosten kurzfristig gewährte Etatansätze vom Parlament einholen . 
Regierung_s23418_f1	Der Kongress hatte ein Gesetz , das die Zahlungsfähigkeit der Regierungkeywordtag bis zum 12. Dezember sicherstellen sollte , an Kürzungen bei Sozialprogrammen gebunden . 
Regierung_s23428_f1	In den vergangenen 14 Jahren mußte die Regierungkeywordtag achtmal Pause machen , in drei Fällen mußten Beschäftigte zu Hause bleiben . 
Regierung_s23429_f1	Zuletzt waren im Oktober 1990 wegen Zahlungsunfähigkeit der Regierungkeywordtag vorübergehende Massenentlassungen erforderlich gewesen . 
Regierung_s23492_f1	Dieser Zeitplan des EWI ist zwar nicht verbindlich , doch dürften sich die Regierungenkeywordtag der an der Währungsunion beteiligten Staaten daran orientieren . 
Regierung_s24219_f1	Demiral forderte kürzlich die Hinrichtung der inhaftierten kurdischen Ex-Parlamentarier , um deren Freilassung sich seit Monaten europäischekeywordtag Menschenrechtler und Regierungenkeywordtag bemühen . 
Regierung_s24348_f1	Die chinesischekeywordtag Regierungkeywordtag nahm die Entscheidung des Dalai Lama im Mai dieses Jahres jedoch nicht zur Kenntnis . 
Regierung_s24497_f1	Regierungkeywordtag will die Todesstrafe abschaffen 
Regierung_s24707_f1	Ich stimme mit fast allen Maßnahmen überein , die die israelischekeywordtag Regierungkeywordtag getroffen hat , um Demokratie und Rechtsstaat in Israel zu schützen . 
Regierung_s24712_f1	Wenn die Maßnahmen der Regierungkeywordtag dazu führen würden , daß diese Tendenz beendet wird , befände ich mich in voller Übereinstimmung mit ihr . 
Regierung_s24716_f1	Doch die Regierungkeywordtag des Friedens kappt mit eigener Hand den Ast , auf dem sie sitzt , wenn sie es vermeidet , den Menschen den hohen Preis zu nennen , den die palästinensische Bevölkerung für Frieden und Versöhnung mit Israel entrichtet hat . 
Regierung_s24724_f1	Wie immer die künftige palästinensischekeywordtag Regierungkeywordtag aussehen mag , die Siedler werden nicht jene Massaker erleiden , die unser Schicksal in Israel waren . 
Regierung_s24796_f1	Parlamentarier aus Nordrhein-Westfalen , die sich über sogenannte `` innerstaatliche Fluchtalternativen '' für Kurden aus den Ostprovinzen der Türkei informieren wollen , sind nach Darstellung des türkischen Generalkonsuls Ömer Altug `` immer herzlich willkommen '' - allerdings unter der Bedingung , daß die türkischekeywordtag Regierungkeywordtag bestimmen kann , wer dieser deutschen Delegation angehört . 
Regierung_s24799_f1	Dem Gesprächsprotokoll ist zu entnehmen , daß die türkischekeywordtag Regierungkeywordtag zwei Delegationsmitglieder von der Liste streichen wollte : den Landtagsabgeordneten Siegfried Martsch ( Bündnis 90 / Die Grünen ) und Certac Bucak , Sprecher des Internationalen Vereins für Menschenrechte in Kurdistan . 
Regierung_s24802_f1	Um jedes Mißverständnis auszuschließen , trug Ömer Altug diese Haltung seiner Regierungkeywordtag zuerst auf deutsch und `` zu seiner Sicherheit '' noch einmal auf englisch vor . 
Regierung_s24804_f1	Nach Ansicht von Roland Appel , Fraktionssprecher von Bündnis 90 / Die Grünen im Düsseldorfer Landtag , beweise die Reaktion der türkischenkeywordtag Regierungkeywordtag und ihre `` mangelnde Dialogbereitschaft '' , daß ein konsequenter Abschiebeschutz für alle kurdischen Flüchtlinge notwendig sei . 
Regierung_s24805_f1	Es sei außerdem überhaupt nicht akzeptabel , daß die türkischekeywordtag Regierungkeywordtag die Zusammensetzung ausländischer Delegationen festlege , sagte der Sprecher der Grünen in Düsseldorf . 
Regierung_s24845_f1	Die Präsidenten Südkoreas und Chinas , Kim Young Sam und Jiang Zemin , haben am Dienstag scharfe Kritik an der japanischenkeywordtag Regierungkeywordtag geübt . 
Regierung_s24968_f1	Regierungkeywordtag hat kein Geld 
Regierung_s24971_f1	Obwohl die Verhandlungen zwischen Präsident Bill Clinton und dem republikanisch beherrschten Kongreß der USA am Dienstag in Washington wiederaufgenommen wurden , um in hektischer Atmosphäre doch noch eine Lösung der tiefen Haushaltskrise zu finden , hat die Regierungkeywordtag rund 800 000 der 2,1 Millionen US-Bundesbediensteten ohne Bezahlung nach Hause geschickt . 
Regierung_s25106_f1	Auch sei die Politik der meisten Regierungenkeywordtag auf eine Liberalisierung des Warenverkehrs und des Kapitalflusses ausgerichtet . 
Regierung_s25109_f1	Die Regierungenkeywordtag könnten aber jederzeit entweder die `` Globalisierung '' des Warenaustausches beschleunigen oder den Prozeß umkehren . 
Regierung_s25136_f1	Studenten der Provinz sitzen der Regierungkeywordtag in Paris im Nacken 
Regierung_s25140_f1	Der Druck von Studenten und Arbeitnehmern auf die französischekeywordtag Regierungkeywordtag wächst . 
Regierung_s25148_f1	Der Protest der Arbeiter entzündete sich an den von der Regierungkeywordtag vorgesehenen Einschnitten bei der staatlichen Sozialversicherung . 
Regierung_s25151_f1	Im französischen Parlament begann eine zweitägige Debatte über die Pläne der Regierungkeywordtag zur Reform des Sozialsystems . 
Regierung_s25266_f1	Unter der Regierungkeywordtag von Bundeskanzler Helmut Kohl ( CDU ) sei die soziale Sicherheit ständig abgebaut worden , die Steuer- und Abgabenlast auf Rekordhöhen geklettert , sagte er . 
Regierung_s25304_f1	Ministerpräsident Eser Weizman traf sich mit Delegationen verschiedener Parteien zu ersten Gesprächen über die Bildung einer neuen Regierungkeywordtag . 
Regierung_s25305_f1	Als sicher gilt , daß die Parteien Weizman empfehlen werden , Schimon Peres mit der Bildung der Regierungkeywordtag zu beauftragen . 
Regierung_s25344_f1	Hier präsentiert sich eine SPD , die ganz anders ist als sie von Berichterstattern im Bonner 	Regierungs- 	und Presseviertel wahrgenommen werden kann . 
Regierung_s25570_f1	Die russischekeywordtag Regierungkeywordtag ist es allerdings leid , in kurzen Abständen immer wieder als Bittsteller auf der Matte zu stehen , und strebt deshalb eine langfristige Lösung an . 
Regierung_s25610_f1	Solange kein Gesamtetat verabschiedet wird , muß die Zahlungsfähigkeit der Regierungkeywordtag mit Sonderetats erhalten werden , die der Kongreß genehmigen muß . 
Regierung_s25645_f1	Mit `` außergewöhnlichen Maßnahmen '' will US-Finanzminister Robert Rubin die völlige Zahlungsunfähigkeit der Regierungkeywordtag in Washington verhindern . 
Regierung_s25653_f1	Rund 800 000 US-Beamte mußten am Dienstag wegen der faktischen Zahlungsunfähigkeit der Regierungkeywordtag in Zwangsurlaub geschickt werden . 
Regierung_s25658_f1	Zuletzt waren im Oktober 1990 wegen Zahlungsunfähigkeit der Regierungkeywordtag vorübergehende Massenentlassungen erforderlich . 
Regierung_s25766_f1	`` So wie die Proteste zunahmen , hat sich die Haltung der Regierungkeywordtag verhärtet . '' 
Regierung_s25878_f1	Sie waren am Montag nach Hause geschickt worden , weil die Regierungkeywordtag ohne gültigen Bundeshaushalt keine Gehälter zahlen kann . 
Regierung_s25884_f1	Regierungkeywordtag und Kongreß machten sich nach dem ergebnislosen Spitzengespräch gegenseitig verantwortlich . 
Regierung_s25894_f1	Das russische Parlament , die Staatsduma , hat dem Sparhaushalt der Regierungkeywordtag für 1996 am Mittwoch zugestimmt . 
Regierung_s25935_f1	Das Riesendefizit der maroden Sozialversicherung gehört zu den drängendsten Problemen der neuen Regierungkeywordtag . 
Regierung_s25949_f1	Die konservativekeywordtag britischekeywordtag Regierungkeywordtag von Premierminister John Major verschärft ihre Asylpolitik und wünscht sich weniger Einwanderer im Vereinigten Königreich . 
Regierung_s25952_f1	Die Regierungkeywordtag Majorkeywordtag kündigte auch Reformen bei der Verbrechensbekämpfung , beim Scheidungsrecht und im Bildungsbereich an . 
Regierung_s25992_f1	Peres , der seit der Ermordung von Ministerpräsident Yitzhak Rabin am 4. November die Regierungsgeschäfte führt , soll am heutigen Mittwoch von Präsident Ezer Weizmann mit der Bildung einer neuen Regierungkeywordtag beauftragt werden . 
Regierung_s26105_f1	Vielmehr eröffnet es gesellschaftlichen Gruppen die Chance , Fehlentscheidungen des Parlaments und der Regierungkeywordtag zu korrigieren und den Legitimationsdruck für Entscheidungen von existentieller Bedeutung wirksam zu erhöhen . 
Regierung_s26488_f1	Die jetzige Regierungkeywordtag versucht , ein gewisses Gleichgewicht herzustellen . 
Regierung_s26564_f1	Vor zwei Wochen hatte die lettischekeywordtag Regierungkeywordtag einen Vertrag mit dem amerikanischen Konzern Amoco und der schwedischen OK unterzeichnet , der den beiden Firmen das Recht auf Ölsuche und -förderung einräumt . 
Regierung_s26566_f1	`` Lettland handelt in Widerspruch zu Zusammenarbeit und Solidarität zwischen den baltischen Staaten und zu gut nachbarschaftlichen Beziehungen '' , empörte sich ein Sprecher des Außenministeriums , und die Regierungkeywordtag rief ihren Botschafter in Riga zu Konsultationen nach Vilnius zurück . 
Regierung_s26576_f1	Die Regierungkeywordtag in Riga dringt auf einen Konsens mit Litauen und will notfalls den Internationalen Gerichtshof in Den Haag anrufen . 
Regierung_s26721_f1	Die Regierungenkeywordtag sind sich uneins und wenden widersprüchliche Bestimmungen an . 
Regierung_s27402_f1	Grund für deren Vorbehalte sind die Verstöße der Regierungkeywordtag in Ankara gegen die Menschenrechte und die Politik gegen die kurdische Minderheit . 
Regierung_s27637_f1	Daß sich die slowakischekeywordtag Regierungkeywordtag nun verstärkt Moskau zuwenden könnte , bestreitet Vizepremier Sergej Kozlik ( HZDS ) im FR-Gespräch . 
Regierung_s28022_f1	Elf Tage nach der Ermordung von Yitzhak Rabin ist der amtierende israelische Ministerpräsident Schimon Peres am Mittwoch abend von Präsident Ezer Weizman erwartungsgemäß mit der Bildung einer neuen Regierungkeywordtag beauftragt worden . 
Regierung_s28234_f1	Der Chefankläger des UN-Tribunals für Kriegsverbrechen in Ex-Jugoslawien , Richter Richard Goldstone , kritisierte die Entscheidung der kroatischenkeywordtag Regierungkeywordtag , General Tihomir Blaskic zu befördern , der in Den Haag wegen mutmaßlicher Verbrechen gegen die Menschlichkeit angeklagt ist . 
Regierung_s28258_f1	Er forderte eine klare politische Entscheidung der mexikanischenkeywordtag Regierungkeywordtag , die Straflosigkeit zu beenden . 
Regierung_s28425_f1	Dies beschloß die Regierungkeywordtag . 
Regierung_s28485_f1	Aufgrund eines Beschlusses der Pariserkeywordtag Regierungkeywordtag vom Mai 1954 ist der Status der Zwangsrekrutierten auf die Elsässer und Lothringer beschränkt , die in der Wehrmacht kämpfen mußten . 
Regierung_s28511_f1	Die Parlamentswahlen vor vier Jahren waren von der Regierungkeywordtag annulliert worden , als sich ein FIS-Sieg abzeichnete . 
Regierung_s28910_f1	Nachdem er eine Mitarbeit in der Regierungkeywordtag bisher stets auf die Zukunft vertagt hatte , erklärte er sich jetzt erstmals zur Kanzlerschaft bereit , sollte die FPÖ die Wahl im Dezember doch noch gewinnen . 
Regierung_s28914_f1	Besonders in der Volkspartei gibt es viele Stimmen , die dem Populisten Haider durch Einbindung in die Regierungkeywordtag den Glamour nehmen möchten . 
Regierung_s29155_f1	Zwar stellt zum Beispiel Singapur erhebliche Mittel zur Verfügung , doch der akademische Nachwuchs der Inselrepublik , so das Eingeständnis der Regierungkeywordtag , zeige für die Wissenschaften wenig Interesse . 
Regierung_s29289_f1	Dafür bin ich als Intendant der Regierungkeywordtag hierkeywordtag natürlich sehr dankbar . 
Regierung_s29668_f1	Die Ressortleiter wollten ihren 	Regierungs- 	und Staatschefs empfehlen , den Plan auf ihrem Gipfeltreffen am Sonntag anzunehmen , fügte er hinzu . 
Regierung_s30368_f1	Außerdem verlangt der Kongreß , daß Clinton als Grundlage für die Haushaltsverhandlungen die Finanz- und Wirtschaftsprognosen des Kongresses akzeptiert , die deutlich pessimistischer sind als die der Regierungkeywordtag . 
Regierung_s30446_f1	Andererseits möchten die meisten westeuropäischenkeywordtag Regierungenkeywordtag und die USA Rußland entgegenkommen , um zusätzlichen Handlungsspielraum für den Friedensprozeß im ehemaligen Jugoslawien zu gewinnen und um die russische Kritik an der Nato-Erweiterung abzumildern . 
Regierung_s30668_f1	Beschäftigte des öffentlichen Dienstes gingen in diesem Jahr massiv gegen Arbeitszeiterhöhungen und rigorose Einsparungen der Regierungkeywordtag Lafontainekeywordtag auf die Straße . 
Regierung_s30719_f1	Die Parteisprecherin der Bündnisgrünen , Krista Sager , sagte der FR , natürlich finde die SPD mit Lafontaine eher zu einer selbstbewußten Opposition gegen die Regierungkeywordtag Kohlkeywordtag zurück . 
Regierung_s30839_f1	In den Verhandlungen mit den westlichenkeywordtag Regierungenkeywordtag geht es um russische Schulden von etwa 40 Milliarden Dollar . 
Regierung_s30922_f1	Zuvor hatte das Repräsentantenhaus das Haushaltsgesetz verabschiedet , das die Handlungsfähigkeit der Regierungkeywordtag bis zum 5. Dezember sichern soll . 
Regierung_s30926_f1	Unterdessen befinden sich wegen des Haushaltsstreits und der weitgehenden Zahlungsunfähigkeit der Regierungkeywordtag rund 800 000 Staatsbedienstete den dritten Tag in Folge in Zwangsurlaub . 
Regierung_s31271_f1	Die Menschenrechtsorganisation amnesty international ( ai ) hat Regierungenkeywordtag und Unternehmen aufgefordert , auf die Junta in Nigeria Druck auszuüben , um weitere inhaftierte Bürgerrechtler des Ogoni-Volkes zu schützen . 
Regierung_s31273_f1	`` Wenn die nigerianischekeywordtag Regierungkeywordtag nicht davor zurückschreckt , unmittelbar vor dem Commonwealth-Gipfel Ken Saro-Wiwa und acht weitere Menschen hinzurichten , müssen wir auch um das Leben der übrigen inhaftierten Ogoni fürchten '' , erklärte amnesty . 
Regierung_s31313_f1	In einer in New York verabschiedeten Erklärung forderte das UN-Gremium die Regierungkeywordtag auf , alles Nötige zu veranlassen , damit die Präsidentschaftswahlen im Dezember friedlich vonstatten gingen . 
Regierung_s31315_f1	Unterdessen setzte sich der ehemalige Parlamentspräsident Duly Brutus in die USA ab , um nach eigenen Angaben den Bedrohungen durch die Regierungkeywordtag zu entgehen . 
Regierung_s31352_f1	Die Regierungkeywordtag teilte nur mit , Rushdies Auftritt bei der Messe sei aus Sicherheitsgründen abgesagt worden . 
Regierung_s31398_f1	Die bosnischekeywordtag Regierungkeywordtag habe in einem Memorandum zudem gefordert , daß nach einem Friedensvertrag das Waffenembargo gegen Bosnien aufgehoben werden solle . 
Regierung_s31402_f1	Wenn die jugoslawischekeywordtag Regierungkeywordtag dem UN-Tribunal für Kriegsverbrechen die volle Zusammenarbeit verweigere , solle ein `` äußerer Sanktionsring '' gegen das aus Serbien und Montenegro bestehende Jugoslawien bestehen bleiben . 
Regierung_s31455_f1	Die französischekeywordtag Regierungkeywordtag zeigte sich verärgert über das Abstimmungsverhalten von zehn EU-Staaten . 
Regierung_s32138_f1	Flugs hat das `` Weltgericht '' von unterschiedlichen Seiten , so von der Bundesregierung in Bonn , die an der Abschreckung festhält , und der australischenkeywordtag Regierungkeywordtag , die Atomwaffen ablehnt , den Rat erhalten , nicht zu entscheiden , da jeder Spruch in eine politische Sackgasse führen müsse . 
Regierung_s32597_f1	Die Nambas heute legen viele dieser vom Urwald überwucherten Ritualplätze für den auch von der Regierungkeywordtag angekündigten Ethnotourismus wieder frei . 
Regierung_s32720_f1	Als Blaupause für das Strategiepapier diente eine von der australischenkeywordtag Regierungkeywordtag entwickelte Gesetzesvorlage , die bereits vor zwei Jahren die politischen Hürden nahm und den Weg für eine innovative Fremdenverkehrsplanung in Down-under frei machte . 
Regierung_s32724_f1	Nach Auskunft der Regierungkeywordtag haben bereits andere Karibik-Staaten ihr Interesse bekundet , das Bahamas-Modell zu übernehmen . 
Regierung_s32960_f1	Seit 1986 arbeitet die Regierungkeywordtag an dem Aufbau eines Sozialversicherungssystems . 
Regierung_s32984_f1	Innerhalb kurzer Zeit sammelt sich immenses Kapital an , das auf den Finanzmärkten Anlagemöglichkeiten sucht und auch der Regierungkeywordtag zur Verfügung steht . 
Regierung_s33048_f1	Regierungkeywordtag will Vorwürfen von amnesty nachgehen 
Regierung_s33050_f1	Die mexikanischekeywordtag Regierungkeywordtag will die von der Menschenrechtsorganisation amnesty international ( ai ) erhobenen Vorwürfe über Menschenrechtsverletzungen in Mexiko prüfen . 
Regierung_s33378_f1	Sie will dabei an die Bonner Politiker appellieren , Druck auf die Regierungkeywordtag ihres Heimatlandes auszuüben . 
Regierung_s33525_f1	In Rußland müssen Regierungkeywordtag und Präsident zustimmen , und auch das Parlament wird mitreden , wenngleich Dawidow dessen Zuständigkeit bestritt . 
Regierung_s33962_f1	So äußerte der Europäische Gewerkschaftsbund ( EGB ) auf seiner Madrider Tagung `` weiterhin Skepsis gegenüber der Frage , ob tatsächlich viele Regierungenkeywordtag willens sind , die Bekämpfung der Arbeitslosigkeit zu einer der obersten Prioritäten zu machen '' . 
Regierung_s34108_f1	Regierungkeywordtag verschärft per `` Notdekret '' die Gesetzgebung / 
Regierung_s34113_f1	Dies ist Presseberichten zufolge der Kern einer Notverordnung , die von der Regierungkeywordtag des parteilosen Ministerpräsidenten Lamberto Dini beschlossen wurde und noch von Staatspräsident Oscar Luigi Scalfaro unterzeichnet werden muß . 
Regierung_s34119_f1	Die Notmaßnahme der Regierungkeywordtag liegt im Verhalten der Lega Nord begründet , die ihre mehrheitsbildende Zustimmung zur anstehenden Haushaltsreform von neuen ausländerrechtlichen Regelungen abhängig gemacht hat . 
Regierung_s34157_f1	Es wird erwartet , daß General Zeroual danach eine neue Regierungkeywordtag bildet . 
Regierung_s34225_f1	In einer Erklärung forderte er die Regierungkeywordtag auf , alles Nötige zu veranlassen , damit die Präsidentschaftswahlen im Dezember friedlich verlaufen . 
Regierung_s34226_f1	Haitis Ex-Parlamentspräsident Duly Brutus setzte sich in die USA ab , um nach eigenen Angaben den Bedrohungen durch die Regierungkeywordtag zu entgehen . 
Regierung_s34280_f1	Einer der Führungsfunktionäre der Miliz , Noor Mohammed Saqib , sagte in einem Telefongespräch mit ap von Peschawar im pakistanischen Grenzland aus , der UN-Unterhändler Mahmoud Mestiri versuche , die Menschen zu täuschen und die Herrschaft der Regierungkeywordtag unter Präsident Burhanuddin Rabbani zu verlängern . 
Regierung_s34314_f1	Seit Ägypten und Pakistan vor einem Jahr einen Auslieferungsvertrag schlossen , hat die Regierungkeywordtag in Islamabad schon mehrere ägyptische Bürger ausgewiesen , die im Verdacht stehen , Feinde Mubaraks zu sein . 
Regierung_s34315_f1	Beide Regierungenkeywordtag arbeiten eng zusammen , um diese Ägypter in Pakistan und auch im benachbarten Afghanistan ausfindig zu machen . 
Regierung_s34319_f1	Die Regierungkeywordtag rief zum weltweiten Kampf gegen Terror auf . 
Regierung_s34425_f1	Die kolumbianischekeywordtag Regierungkeywordtag hat dem früheren haitianischen Diktator Prosper Avril politisches Asyl gewährt . 
Regierung_s34442_f1	Japanskeywordtag Regierungkeywordtag begrüßte unterdessen die Erklärungen von US-Präsident Bill Clinton zur Bedeutung der gegenseitigen Beziehungen und Clintons Wunsch , den abgesagten Staatsbesuch möglichst bald nachzuholen . 
Regierung_s34561_f1	Gegner des umstrittenen Gasprojekts , das Shell zusammen mit der nigerianischenkeywordtag Regierungkeywordtag sowie Unternehmen aus Italien und Frankreich im Stammesgebiet der Ogoni verwirklichen will , protestierten am Wochenende vor Shell-Tankstellen in Großbritannien . 
Regierung_s34597_f1	Angesichts der Haushaltsschwierigkeiten hatte die Regierungkeywordtag von den Eltern jedoch eine Beteiligung an den Schulkosten in Höhe von 25 Pesos ( rund 35 Mark ) pro Kind verlangt . 
Regierung_s34613_f1	Vielmehr erklärte er , daß er Platz für einen Kroaten machen müsse , um den Proporz in der Regierungkeywordtag der kroatisch- moslemischen Föderation herzustellen . 
Regierung_s34633_f1	Zehntausende von Italienern haben am Wochenende gegen die umstrittene Ausländer-Notverordnung der Regierungkeywordtag und den wachsenden Rassismus im Land demonstriert . 
Regierung_s35230_f1	Die Regierungkeywordtag sieht sich jetzt in einem Dilemma . 
Regierung_s35394_f1	Entgegen einer zwingenden Vorschrift der Landesverfassung habe die Regierungkeywordtag in ihrem Gesetzentwurf die Kosten nicht angegeben . 
Regierung_s35697_f1	Dazu gehöre auch , daß die Regierungkeywordtag sogar den Konkurs bei dem Unternehmen Saarstahl ausdrücklich begrüßt habe . 
Regierung_s35700_f1	`` Wir haben die faulste Regierungkeywordtag und den faulsten Ministerpräsidenten der Republik '' , monierte Müller . 
Regierung_s35796_f1	Die griechischekeywordtag Regierungkeywordtag kritisierte , daß der Rektor und der Senat der Hochschule der Polizei nicht früher die Erlaubnis zum Eingreifen gaben . 
Regierung_s35862_f1	Mit dem Bombenanschlag gegen die ägyptische Botschaft in der pakistanischen Hauptstadt Islamabad haben die Moslem-Extremisten Ägyptens im Vorfeld der bevorstehenden Parlamentswahlen signalisiert , daß sie eine Kraft geblieben sind , um Staatspräsident Hosni Mubarak und seinekeywordtag Regierungkeywordtag zu bedrohen . 
Regierung_s36387_f1	Am Runden Tisch zwischen Regierungkeywordtag und ehemals verbotener Opposition galt er als einer der konzilianteren Unterhändler , und manche schreiben ihm sogar die damals revolutionäre Idee des demokratisch gewählten Senats zu . 
Regierung_s36411_f1	Die israelischekeywordtag Regierungkeywordtag richtete am Sonntag eine Arbeitsgruppe ein , die sich mit der Bekämpfung jüdischer Extremisten beschäftigen soll . 
Regierung_s36430_f1	Gegner des umstrittenen Gasprojekts , das Shell mit der nigerianischenkeywordtag Regierungkeywordtag sowie Unternehmen aus Italien und Frankreich im Gebiet der Ogoni verwirklichen will , protestierten am Wochenende vor Shell-Tankstellen in Großbritannien . 
Regierung_s36465_f1	Seit Ägypten und Pakistan vor einem Jahr einen Auslieferungsvertrag schlossen , hat die Regierungkeywordtag in Islamabad schon mehrere ägyptische Bürger ausgewiesen , die im Verdacht stehen , Feinde Mubaraks zu sein . 
Regierung_s36466_f1	Beide Regierungenkeywordtag arbeiten eng zusammen . 
Regierung_s36510_f1	Gleich hoch veranschlagt die Bonnerkeywordtag Regierungkeywordtag das Plus bei den Bruttoanlageinvestitionen . 
Regierung_s36593_f1	Börsianer sehen die Ursache in den Versuchen der Regierungkeywordtag , einen großen Teil des vom IWF koordinierten Beistandkredits in Höhe von 57 Milliarden Dollar noch vor Jahresende nach Südkorea zu holen . 
Regierung_s36619_f1	Vorgänger Christian Blanc war zurückgetreten , weil die sozialistischekeywordtag Regierungkeywordtag eine Privatisierung von Air France abgelehnt hatte . 
Regierung_s36922_f1	Die brasilianischekeywordtag Regierungkeywordtag will mit Privatisierungen in den nächsten zwei Jahren mindestens 95 Milliarden Mark einnehmen . 
Regierung_s37069_f2	Inzwischen leuchten die roten Warnlämpchen bei den Regierungenkeywordtag von Bonn bis Washington . 
Regierung_s37122_f1	Die Regierungkeywordtag der Stadt will sich in die Auseinandersetzung einschalten . 
Regierung_s37569_f1	Die Regierungkeywordtag von Malaysia unternimmt noch einmal einen Anlauf , Reste des niederländischen Flugzeugbauers Fokker zu retten . 
Regierung_s37572_f1	`` Jetzt gibt es eine bessere Mitwirkung der Regierungenkeywordtag '' , erläutert Khazanah-Direktor Abdul Rshid Hussain , der damit offenbar eine mögliche Beteiligung des niederländischen Staates andeuten will . 
Regierung_s37573_f1	Allerdings : Im vergangenen Jahr war ein fix und fertig ausgehandelter Vertrag zwischen dem südkoreanischen Konzern Samsung und Fokker im letzten Moment geplatzt , weil die Regierungkeywordtag in Den Haag nicht zu den von den Asiaten verlangten Garantien bereit war . 
Regierung_s37575_f1	Auch hierbei spielte die Weigerung der Regierungkeywordtag eine wesentliche Rolle , eine spezielle Steuerkonstruktion mitzutragen , die das Durchstarten hätte ermöglichen sollen . 
Regierung_s37814_f1	Die Pariserkeywordtag Regierungkeywordtag hat Gespräche mit der politischen Führung in Belgien über Möglichkeiten zur Rettung von Arbeitsplätzen aufgenommen . 
Regierung_s38445_f1	Ein `` Enarch '' , der wie Jospin und einige andere Mitglieder der neuen Regierungkeywordtag , die berühmte Kaderschmiede der Nation , ENA , durchlief , ist er nicht . 
Regierung_s38453_f1	1988 lehnte er ein Angebot Michel Rocards ab , in die Regierungkeywordtag einzutreten . 
Regierung_s39166_f1	Seit der Bankenkrise anfangs der neunziger Jahre , bei der die Regierungkeywordtag in Oslo bedrängten Finanzhäusern helfen mußte , hält diese 51 Prozent an Kreditkassen und hätte damit ein Viertel der Christiania-Aktien kontrolliert . 
Regierung_s39211_f1	Dies erklärt die französischekeywordtag Regierungkeywordtag . 
Regierung_s39390_f1	Wenn die Regierungkeywordtag endlich die Löhne und Renten auszahlen will , die sie Bergarbeitern , Krankenschwestern , Soldaten und Ruheständlern seit Monaten schuldet , muß mehr Geld in die Kasse . 
Regierung_s39414_f1	Erst am 11. März hatte die Regierungkeywordtag beschlossen , Kulikow und Tschubais gemeinsam mit dieser Aufgabe zu betrauen . 
Regierung_s39440_f1	Schließlich wurden ja auch mit Billigung der Regierungkeywordtag alle maßgeblichen Raumfahrtfirmen unter dem Dach von Daimler-Benz Aerospace ( Dasa ) zusammengeholt . 
Regierung_s39783_f1	In den späten siebziger Jahren Heimat alter Lagerhallen , mit Container-Kais , Kränen und kleinen Pubs für die Schauerleute , sind sie in den achtziger Jahren in einem gemeinsamen Kraftakt von konservativerkeywordtag Regierungkeywordtag und Privatwirtschaft in eine Schaubühne der Neuzeit umgemodelt worden - in ein Areal super-moderner Büro-Hochhäuser , geruchloser Kleinbetriebe , velours-belegter Luxus-Geschäfte , privat betriebener Massenverkehrsmittel . 
Regierung_s39817_f2	Zwei Jahre lang , kündigte Brown an , würde eine Labour-Regierung sich an die Ausgaben-Pläne der Regierungkeywordtag Majorkeywordtag halten . 
Regierung_s39959_f1	Denn sie argumentieren , nur wenn die deutschekeywordtag Regierungkeywordtag durch den Bau einer Transrapid-Verbindung ihr Vertrauen in diese neue Technik demonstriere , ließe sich diese exportieren und damit versilbern . 
Regierung_s40066_f1	Nachdem sie bereits beim Börsengang der Deutschen Telekom eine führende Rolle gespielt hatte , fiel nun auch die Wahl der Regierungkeywordtag in Ankara auf diese internationale Top-Adresse . 
Regierung_s40076_f1	Bereits zweimal hatte der IWF im vergangenen Jahr Zahlungen aus einem Großkredit über zehn Milliarden Dollar zurückgehalten , weil die Regierungkeywordtag die veranschlagten Steuereinnahmen nicht verbuchen konnte . 
Regierung_s40079_f1	Die von Samsung Aerospace geführte Firmengruppe hatte sich vor allem über die von der niederländischenkeywordtag Regierungkeywordtag geforderten Arbeitsplatzgarantien zerstritten . 
Regierung_s40091_f1	Gegen erste protektionistische Schritte von seiten der USA werde die mexikanischekeywordtag Regierungkeywordtag jetzt entschlossen vorgehen , betont Blanco . 
Regierung_s40580_f1	Eine Welle der Empörung haben die von der Bonnerkeywordtag Regierungkeywordtag im Entwurf für den Haushalt 1998 geplanten Abstriche im Etat von Bauminister Klaus Töpfer losgetreten . 
Regierung_s40586_f1	Den Wohngeldbeitrag des Bundes - bislang steuern mindestens ebensoviel die Länder zusätzlich bei - will die Regierungkeywordtag auf 3,5 Milliarden Mark per annum festzurren . 
Regierung_s40593_f1	Für den Mieterbund ist dies `` die Bankrotterklärung für die Wohnungspolitik der Regierungkeywordtag '' . 
Regierung_s40676_f1	Genau das versucht die Regierungkeywordtag aber derzeit . 
Regierung_s41140_f1	Insgesamt mußten in Thailand schon 58 von ursprünglich 91 Geldhäusern aufgeben , obwohl die Regierungkeywordtag rund 16 Milliarden Dollar in den maroden Finanzsektor gepumpt hat . 
Regierung_s41369_f1	Vorgesehen sind auch routinemäßige Untersuchungen der Transparenz und Verläßlichkeit einer Regierungkeywordtag , die einen Kredit erhalten hat . 
Regierung_s41379_f1	So habe er zum Beispiel in Kenia und in Zaire jahrelang deutliche Hinweise auf Korruption der dortigenkeywordtag Regierungenkeywordtag ignoriert . 
Regierung_s41584_f1	Auch Zweifel an der wirtschaftspolitischen Kompetenz einiger Regierungenkeywordtag , etwa in Bangkok und Kuala Lumpur , werden als Gründe für die Verluste genannt . 
Regierung_s41641_f1	Angesichts der `` sehr starken amerikanischen Konkurrenz '' wolle die Regierungkeywordtag insbesondere auf den Gebieten Luftfahrt und Elektronik `` eine entschieden europäische Wahl '' treffen , sagte er in einer Rede vor den französischen Botschaftern . 
Regierung_s41936_f1	In Kasachstan bat er die Regierungkeywordtag , Stolpersteine für ein Engagement deutscher Firmen aus dem Weg zu räumen . 
Regierung_s42315_f1	Der IWF hatte vor kurzem ein internationales Hilfspaket von 17 Milliarden Dollar für Thailand gezimmert , will die Auszahlung aber nach Zeitungsberichten stoppen , falls die Regierungkeywordtag die vereinbarten Reformen nicht schneller umsetzt . 
Regierung_s42424_f1	Die Regierungenkeywordtag müßten etwa bei der kommenden Klimaschutz-Konferenz der Vereinten Nationen in Kyoto solche Normen festlegen und beispielsweise Energiesteuern vereinbaren . 
Regierung_s42631_f1	Der ehemalige baden-württembergische Ministerpräsident Späth lobt denn auch den `` sicher nicht einfachen '' Entschluß , den die Regierungkeywordtag auch vor dem Landtag verantworten muß . 
Regierung_s42656_f1	Es passe nicht zu der von der Bonnerkeywordtag Regierungkeywordtag beschlossenen CO2-Reduzierung , wenn eines der wenigen Instrumente , um die Kohlendioxid-Emissionen zu verringern , derart beschnitten werde . 
Regierung_s42716_f1	Die damals längste auf dem Kontinent koppelt die Regierungkeywordtag mit der aufsässigen Nationalversammlung in der Paulskirche . 
Regierung_s42984_f1	Ein Vertreter des Verkehrsministeriums in Tokio kündigte an , die Regierungkeywordtag werde die USA dazu drängen , die Strafen aufzuheben . 
Regierung_s43149_f1	Sollten die Regierungenkeywordtag die Punkte nicht beseitigen , kann das Gremium die Staaten vor dem Europäischen Gerichtshof verklagen . 
Regierung_s43600_f1	Die Regierungkeywordtag in Seoul kündigt an , sie werde das Land für ausländische Anleger öffnen , die Steuern erhöhen und die Staatsausgaben drastisch kürzen . 
Regierung_s43614_f1	Hoffnungslos zahlungsunfähige Institute möchte die Regierungkeywordtag schließen . 
Regierung_s43621_f1	Kernpunkt sei jetzt , daß die Regierungkeywordtag ihre Versprechen tatsächlich einhalte . 
Regierung_s43719_f1	Der Bundesrat forderte die Regierungkeywordtag auf , sich für den Erhalt des steuerfreien Einkaufs in Brüssel einzusetzen . 
Regierung_s44275_f1	Der Abgeordnete Albert Schmidt von Bündnis 90 / Die Grünen versucht seit Monaten seiner Pflicht als Parlamentarier nachzukommen und die Regierungkeywordtag zu kontrollieren . 
Regierung_s44643_f1	Ida Mauss , Ehefrau des deutschen Privatagenten Werner Mauss , hat aus dem Gefängnis in Medellin an die kolumbianischekeywordtag Regierungkeywordtag appelliert , Frieden mit der kommunistischen Guerilla zu schließen . 
Regierung_s44646_f1	Diese Position vertritt auch die Bonnerkeywordtag Regierungkeywordtag . 
Regierung_s44709_f1	Die Hongkongerkeywordtag Regierungkeywordtag hat am Freitag das vietnamesische Flüchtlingslager Whitehead im Stadtteil Sha Tin geschlossen . 
Regierung_s44881_f1	Ein Sprecher des Außenministeriums in Washington sagte , seine Regierungkeywordtag sei der Ansicht , es sei für eine `` Weltmacht '' wie die USA nicht angemessen , ein säumiger Geber der UN zu sein . 
Regierung_s44883_f1	Die Regierungkeywordtag in Washington habe von dem neuen Generalsekretär eine sehr hohe Meinung . 
Regierung_s44943_f1	Die Regierungkeywordtag in Kigali wirft ihm vor , in Reden zu dem Massenmord aufgefordert und Massaker organisiert zu haben . 
Regierung_s44956_f1	Nichts deute darauf hin , daß Peruskeywordtag Regierungkeywordtag und die Rebellen der Revolutionären Bewegung Tupac Amaru bald zu einer Einigung kämen , sagte Biegler am Freitag im ZDF . 
Regierung_s44974_f1	Seine Regierungkeywordtag sei der Ansicht , es sei für eine `` Weltmacht '' wie die USA nicht angemessen , ein säumiger Geber der UN zu sein , sagte der Sprecher des Außenministeriums . 
Regierung_s44982_f1	Die serbischekeywordtag Regierungkeywordtag hat den von ihr bisher abgestrittenen Sieg der Opposition bei der Kommunalwahl in 9 der 16 Wahlkreise von Belgrad und drei Gemeinden anerkannt . 
Regierung_s45024_f1	Erstmals hat auch die Serbisch-Orthodoxe Kirche der Regierungkeywordtag Wahlbetrug vorgeworfen . 
Regierung_s45049_f1	In einer am Freitag in Guhawahati veröffentlichten Erklärung heißt es , die Gruppe habe den Zug angegriffen , weil die Regierungkeywordtag sich bis Dezember 1996 geweigert habe , der Forderung der Organisation nach einem eigenen Staat für den Bodo-Stamm nachzukommen . 
Regierung_s45288_f1	Anschlag zeigt den Haß gegen Syrienskeywordtag Regierungkeywordtag 
Regierung_s45290_f1	Trotz des modernen Nachrichtenwesens ist es der syrischenkeywordtag Regierungkeywordtag gelungen , Informationen über den Anschlag auf einen Bus tagelang unter Verschluß zu halten . 
Regierung_s45454_f1	Sollte das Abkommen im Kabinett scheitern , könnte Netanyahu als einziger Ausweg eine Neubildung der Regierungkeywordtag unter Einbeziehung der Opposition bleiben . 
Regierung_s45456_f1	Vorerst durchsetzen konnte sich die Regierungkeywordtag Netanyahukeywordtag gegen eine Gruppe von rund 200 jüdischen Siedlern , die Wohncontainer auf einem Hügel nahe des Dorfes El Beit aufgestellt hatten , um eine neue Siedlung zu errichten . 
Regierung_s45580_f1	Bosnien-Herzegowina hat nach fast vier Jahren Krieg und innenpolitischen Wirren eine gemeinsame Regierungkeywordtag von Kroaten , Moslems und Serben . 
Regierung_s45615_f1	Die serbischekeywordtag Regierungkeywordtag hat den von ihr bisher abgestrittenen Sieg der Opposition bei der Kommunalwahl in 9 der 16 Wahlkreise von Belgrad anerkannt . 
Regierung_s45617_f1	Ob dies dazu führt , daß die Opposition in der Hauptstadt die Regierungkeywordtag übernimmtkeywordtag , war unklar . 
Regierung_s45887_f1	Die Regierungkeywordtag Luxemburgskeywordtag ist damit den Banken weit entgegengekommen . 
Regierung_s45932_f1	Es war kein Zufall , sondern Politik der großherzoglichenkeywordtag Regierungkeywordtag , im Zusammenhang des Investmentfond-Gesetzes und der Steueranreize für private Vermögensanlagen ( `` Privatkundengeschäft '' ) Ende der 70er Jahre auch das Bankgeheimnis gesetzlich zu verankern , nachdem es vorher jahrzehntelange Praxis gewesen war . 
Regierung_s45970_f1	Das neue Standortsicherungsprogramm der Regierungkeywordtag Junckerkeywordtag bedeutet den Einstieg in den Abbau des Wohlstands- und Sozialstaats . 
Regierung_s45975_f1	Zum neuen Standortsicherungsprogramm der Regierungkeywordtag gehört auch die `` Abwassertaxe '' . 
Regierung_s45977_f1	Damit will die Regierungkeywordtag ihr 24-Milliarden-Programm zum Bau von Kläranlagen finanzieren . 
Regierung_s46029_f1	Die Luxemburgerkeywordtag Regierungkeywordtag ist sich dessen durchaus bewußt und stellt sich dieser Problematik durchaus positiv . 
Regierung_s46384_f1	400 000 Häuser möchte die ruandischekeywordtag Regierungkeywordtag bis März am liebsten gebaut haben , mit kräftiger Unterstützung der Geberländer . 
Regierung_s46391_f1	Diese Altflüchtlinge , die zum großen Teil die soziale und politische Basis der jetzigen Regierungkeywordtag bilden , müssen nun vor den zurückkehrenden Hutus weichen ; 
Regierung_s46392_f1	denn die Regierungkeywordtag sichert jedem Heimkehrer zu , innerhalb von zwei Wochen sein früheres Haus wieder beziehen zu dürfen . 
Regierung_s46393_f1	So gerecht und so versöhnend das wirken mag , die Tutsi sehen sich oft als von ihrerkeywordtag Regierungkeywordtag verraten : 
Regierung_s46416_f1	Die Regierungkeywordtag hat die Parole ausgegeben , man solle erst mal stillhalten , wenn man einen der früheren Mörder wiedertreffe , bis die Rückkehrerwelle abgeebbt sei , später werde man weitersehen . 
Regierung_s46427_f1	nach 25 Tagen bauten sie kurz vor Jahresende ihre Straßensperren ab , ohne daß es ihnen gelungen wäre , der Regierungkeywordtag nennenswerte Zugeständnisse abzuringen . 
Regierung_s46451_f1	Den vielfältigen Möglichkeiten , die Ausgaben zu beschneiden , widmet die sozialistischekeywordtag Regierungkeywordtag bisher nur wenig Aufmerksamkeit . 
Regierung_s46829_f1	Der chinesische Außenminister Qian Qichen erklärte , seine Regierungkeywordtag sei völlig überrascht worden von der Flucht des Nordkoreaners in die Pekinger Botschaft Südkoreas . 
Regierung_s46834_f1	In Seoul erklärte ein Regierungsvertreter , Peking sei verärgert darüber , daß Regierungkeywordtag und Medien in Südkorea die Flucht Hwangs `` hinausposaunt '' hätten . 
Regierung_s47111_f1	Die Schweizerkeywordtag Regierungkeywordtag reagierte zurückhaltend , es liege keine Bestätigung vor , daß der Geiselaustausch begonnen habe . 
Regierung_s47313_f1	Die Regierungkeywordtag in Tirana bezeichnete die Berichterstattung ausländischer Fernsehanstalten als einseitig . 
Regierung_s47383_f1	Die italienischekeywordtag Regierungkeywordtag hat per Notverordnung die Einführung des kommunalen Wahlrechts für Ausländer beschlossen . 
Regierung_s47414_f1	Nach einem Gespräch mit seinem südkoreanischen Kollegen Yoo Chong Ha sagte Chinas Außenminister Qian Qichen am Freitag in Singapur , seine Regierungkeywordtag benötige noch Zeit , um eine Entscheidung zu treffen . 
Regierung_s47416_f1	In Seoul sagte ein Regierungsvertreter , Peking sei darüber verärgert , daß Regierungkeywordtag und Medien in Südkorea Hwangs Flucht `` hinausposaunt '' hätten . 
Regierung_s49372_f1	Die Regierungkeywordtag in Sarajevo akzeptierte den Schiedsspruch , betonte aber dessen Vorläufigkeit . 
Regierung_s49744_f1	Kanzleramtsminister Friedrich Bohl ( CDU ) sagte im Saarländischen Rundfunk , für Erwartungen eines neuen Angebots seitens der Regierungkeywordtag sei `` kein Raum '' . 
Regierung_s49820_f1	Die Regierungkeywordtag wollte einen Riegel vorschieben und ordnete Kontrollen und Strafen für die Betrüger an . 
Regierung_s49903_f1	Die Abgeordneten verabschiedeten am Montag einen gemeinsamen Gesetzesentwurf von Regierungkeywordtag und Opposition . 
Regierung_s49942_f1	Die Regierungkeywordtag bestreitet das . 
Regierung_s49954_f1	Die albanischekeywordtag Regierungkeywordtag und neun Oppositionsparteien haben sich am Montag abend in Tirana auf die Grundstruktur einer Übergangsregierung geeinigt . 
Regierung_s49957_f1	Demnach soll die `` Regierungkeywordtag der Nationalen Versöhnung '' 15 Ministerien umfassen , die Regierungs- und Oppositionsparteien zwischen sich aufteilen wollen . 
Regierung_s49972_f1	Damit hat die Regierungkeywordtag die Kontrolle über Südalbanien völlig verloren . 
Regierung_s50054_f1	Gestützt auf eine Umfrage und ein amtliches Gutachten beantragte die Regierungkeywordtag von Ministerpräsident Alain Juppé in Brüssel , die Ende des Jahres auslaufende EU-Richtlinie zur Sommerzeit nicht mehr zu verlängern . 
Regierung_s50126_f1	Nach einem am Dienstag in London veröffentlichten Bericht werden die Übergriffe sowohl von Sicherheitskräften der Regierungkeywordtag als auch von der bewaffneten Opposition verübt . 
Regierung_s50127_f1	Seit der Kriegserklärung der maoistischen Kommunistischen Partei Nepals gegenüber der Regierungkeywordtag am 13. Februar 1996 seien 50 Menschen ermordet worden , so ai . 
Regierung_s50141_f1	Wie aus diesen Kreisen am heutigen Montag morgen in Jemens Hauptstadt Sanaa verlautete , gibt es Fortschritte , ohne daß die Regierungkeywordtag Zugeständnisse an die Entführer mache . 
Regierung_s50144_f1	Die Behörden gehen zudem davon aus , daß die Geiselnehmer , Angehörige jemenitischer Stämme , Druck auf die Regierungkeywordtag in Sanaa ausüben wollen : 
Regierung_s50196_f1	Regierungkeywordtag verhandelt mit Geiselnehmern 
Regierung_s50199_f1	Aus den Kreisen verlautete am Montag in Jemens Hauptstadt Sanaa , Zugeständnisse der Regierungkeywordtag gebe es aber keine . 
Regierung_s50207_f1	Die Behörden gehen zudem davon aus , daß die Geiselnehmer - Angehörige jemenitischer Stämme - Druck auf die Regierungkeywordtag in Sanaa ausüben wollen . 
