schliessen_s91_f0	Die mächtigen Gewerkschaften haben bisher verhindert , daß unrentable Firmen 	geschlossen 	oder privatisiert werden . 
schliessen_s778_f0	Lebensfähige Betriebe würden privatisiert , nicht konkurrenzfähige 	geschlossen 	, erklärte Mitsotakis und verschwieg auch nicht , daß sein Kurs zwangsläufig mit dem Verlust von Arbeitsplätzen verbunden sei . 
schliessen_s943_f0	Peterskeywordtag 	schließt 	mit der Synthese , daß so gesehen `` moderne '' Mystik und Gesellschaftspolitik zusammengehören : 
schliessen_s2437_f0	Mit einer pessimistischen Bilanz über die Lage der Menschenrechte im arabischen Raum 	schließt 	der Jahresbericht der `` Arabischen Organisation für Menschenrechte '' für 1991 . 
schliessen_s3181_f0	Aus Andeutungen , Gesprächen und Denkmodellen 	schließt 	die Organisation , daß bis Ende 1999 insgesamt 58 500 Arbeitsplätze zur Disposition stehen . 
schliessen_s4016_f0	Überdies hätte die Ehe nicht 	geschlossen 	werden dürfen , weil Lisa Marie Presley erst drei Wochen zuvor von dem Musiker Danny Keough geschieden worden sei . 
schliessen_s4273_f0	Wegen der durch Wassereinbrüche und Salzablagerungen hervorgerufenen Schäden an den Fresken war die Grabkammer bisher für die Öffentlichkeit 	geschlossen 	. 
schliessen_s4559_f0	Auch mit Syrien wird es eine Möglichkeit geben , Friedenkeywordtag zu schließen . 
schliessen_s4683_f0	Unter Rabin waren die Friedensverträgekeywordtag Israels mit der Palästinensischen Befreiungsorganisation und mit Jordanien 	geschlossen 	worden . 
schliessen_s5431_f0	Schon früh , lange vor den meisten Politikern in Israel , hatte er von der Notwendigkeit gesprochen , Friedenkeywordtag mit den Feinden zu schließen . 
schliessen_s5634_f0	Rabin hat in Reden gerne darauf aufmerksam gemacht , daß `` Friedekeywordtag nicht zwischen Freunden , sondern zwischen Feinden 	geschlossen 	wird '' . 
schliessen_s6513_f0	Die Nato will bis zu 60 000 Soldaten nach Bosnien schicken , sollten die Präsidenten Bosniens , Kroatiens und Serbiens in Dayton / Ohio ein Friedensabkommenkeywordtag 	schließen 	. 
schliessen_s6762_f0	Die von einem Datenbankproblem vorübergehend lahmgelegte Frankfurter Aktienbörse hat zum Wochenbeginn etwas schwächer 	geschlossen 	. 
schliessen_s6770_f0	Hoechstkeywordtag zogen zunächst an , 	schlossen 	dann aber um 2,20 Mark niedriger . 
schliessen_s7563_f0	Große Koalitionen dürfen nur in Ausnahmefällen und auf begrenzte Zeit 	geschlossen 	werden . 
schliessen_s8355_f0	Hubschrauber sicherten den Luftraum über Jerusalem , derkeywordtag für jeden Luftverkehr 	geschlossen 	war . 
schliessen_s9065_f0	`` Mankeywordtag 	schließt 	kein Atomkraftwerk , das 200 Millionen Dollar im Jahr einbringt , Millionen Menschen Strom liefert und 25 000 Menschen eine Beschäftigung bietet '' , sagte Paraschin diese Woche der finnischen Tageszeitung Vasabladet : 
schliessen_s10231_f0	In seinem Grundsatzreferat sagte er , die IG BAU wolle ein `` neues Bündniskeywordtag von Arbeit und Natur 	schließen 	'' . 
schliessen_s10479_f1	Daß die Türen von Bekleidungs- und Schuhgeschäften , Möbel- und Warenhäusern , Boutiquen , Apotheken und bei `` Tante Emma '' später 	geschlossen 	werden , entlastet vorneweg Berufstätige . 
schliessen_s10539_f0	Die Führer der großen Oppositionsparteien 	schlossen 	mit der Regierung von Präsident Henri Konan Bédié ein Übereinkommenkeywordtag , das allen Gruppierungen die Teilnahme an den Parlamentswahlen am 26. November erlaubt . 
schliessen_s11153_f0	Erkeywordtag kaufte das Weinlokal - um eskeywordtag zu schließen . 
schliessen_s11929_f0	Neben der Identität als `` Partei der sozialen Gerechtigkeit '' vermöge die SPD die Lücke zu den sogenannten `` Modernisierungsverlierern '' wie an- und ungelernten Arbeitern , Arbeitslosen und Sozialhilfeempfängern nicht zu schließen . 
schliessen_s12565_f0	Als die Delegation den Kontrollpunkt Erez Richtung Jerusalem passiert , ist dieserkeywordtag für Normalbürger wegen eines Selbstmordanschlages im Gaza-Gebiet wieder einmal 	geschlossen 	. 
schliessen_s13959_f0	Dänischer Schiffbauer muß 	schließen 	/ 
schliessen_s15259_f0	Aus der Hinnahme der Kündigung dürfe nicht 	geschlossen 	werden , daß der Arbeitnehmer damit einem Aufhebungsvertrag zugestimmt habe . 
schliessen_s16801_f0	Einige Hotels 	schließen 	aber in den Wintermonaten . 
schliessen_s16948_f0	An der Theke des Traiteurs an der Ecke gehört der Tratsch zum guten Ton , und Hotelauskünfte gibt - falls das Fremdenverkehrsbüro 	geschlossen 	ist - auch die Polizei . 
schliessen_s17335_f0	Mit der Dämmerung 	schließen 	die Geschäfte , und man geht zum Essen in eines der Restaurants . 
schliessen_s18835_f0	Die Teilnehmer an der 3. Stufe sollen einen `` Stabilitätspakt für Europa '' 	schließen 	. 
schliessen_s18863_f0	Sämtliche elf Häuser seien derzeit 	geschlossen 	, da die Ware unter Eigentumsvorbehalt stehe . 
schliessen_s19914_f0	Eine schleichende Verstaatlichung der Ausbildung kann eintreten , wenn der Staat immer wieder durch überbetriebliche und steuerfinanzierte Angebote größer werdende Ausbildungslücken 	schließt 	. 
schliessen_s20261_f0	Ein planloses Draufhauen führt nur dazu , daß sich auf der anderen Seite die Reihen fester 	schließen 	. 
schliessen_s20430_f1	Die Veteranen werden zwar vergeblich auf ihre Schecks warten , Pässe werden nicht mehr ausgestellt , Zivilprozesse verschoben und alle Nationalparks und Museen 	geschlossen 	. 
schliessen_s21008_f0	Seine Bank wollte die Filiale in Hongkong 	schließen 	und hatte ihm `` empfohlen '' , Angeboten anderer Arbeitgeber näherzutreten . 
schliessen_s21029_f0	Anstatt in Bonn um mehr Geld für die Berliner Kultur zu kämpfen , solle jetzt in Berlin `` reihenweise 	geschlossen 	werden '' , kritisierte Sühlo . 
schliessen_s21580_f0	Die Dividendenwerte haben am Montag gemessen am Deutschen Aktienindex ( Dax ) wenig verändert 	geschlossen 	. 
schliessen_s22791_f0	Vulkan 	schließt 	Vertragkeywordtag / 
schliessen_s22802_f0	Die Münchner 	schlossen 	zudem einen Vorvertrag über das Kraftwerk Hanfeng in Hebei . 
schliessen_s22826_f0	Haben die Rektoren und Präsidenten der Hochschulen einen heimlichen Paktkeywordtag mit den Studenten 	geschlossen 	, um endlich einmal Schlagzeilen zu machen ? 
schliessen_s23423_f0	Er sei zuversichtlich , daß die Bundesbehörden nur einen Tag 	geschlossen 	blieben . 
schliessen_s24174_f1	In der Royal Academy 	schließt 	der Überblick an der Schwelle unserers Jahrhunderts , aber mehrere andere Londoner Ausstellungen setzen ihn bis in die Gegenwart fort . 
schliessen_s24385_f0	Im Juni wurde ein Vertragkeywordtag mit der Stadt Frankfurt über die Erteilung der Wegerechte und die Nutzung der Leerrohre 	geschlossen 	. 
schliessen_s24465_f0	Lamfalussy sagte , er unterstütze voll die Motivation hinter dem Vorschlag von Bundesfinanzminister Theo Waigel , einen Stabilitätspakt für Europa zu schließen . 
schliessen_s25602_f0	Am Dienstag mittag 	schlossen 	landesweit Gedenkstätten , Museen und Nationalparks , weil der Bundesregierung das Geld für das Personal ausging . 
schliessen_s25604_f0	Im Museumsviertel der Hauptstadt sind die mit Bundesgeldern finanzierten Ausstellungsräume 	geschlossen 	, weshalb dort die Touristen ausbleiben . 
schliessen_s25617_f0	Auch das Washington Monument ist 	geschlossen 	, aber gleich neben dem meilenweit sichtbaren Nationaldenkmal wühlen drei Männer im Schlamm . 
schliessen_s25864_f0	Parks und Museen wegen Haushaltskrise 	geschlossen 	/ 
schliessen_s25991_f0	Er hoffe , daß Israel in den kommenden fünf Jahren sowohl mit den Palästinensern als auch mit Syrien und Libanon Friedensverträgekeywordtag 	schließen 	werde . 
schliessen_s26168_f0	Umgekehrt schafft die Bereitschaft von sozialen Gruppen und Nationen , sich mit eigenen Fähigkeiten und natürlichen Ressourcen zufriedenzugeben und darauf zu verzichten , den eigenen Wohlstand auf Kosten anderer zu vermehren , erst die Grundlage dafür , daß Menschen untereinander wie auch mit der Natur Friedenkeywordtag 	schließen 	. 
schliessen_s26282_f0	12-22 Uhr , samstags , sonntags und an Feiertagen ab 10 Uhr , dienstags 	geschlossen 	. 
schliessen_s26410_f0	Schließlich wird der Vertragkeywordtag nicht mit der Universität , sondern mit der Vermittlungsgesellschaft 	geschlossen 	. 
schliessen_s26748_f0	Drei Kreise 	schlossen 	sich zu einem kulturgeschichtlichen Zusammenhalt . 
schliessen_s27092_f0	Schulen und Wochenmärkte sind seit Montag 	geschlossen 	, alle Sportveranstaltungen wurden verschoben , die Straßensperren um Algier militärisch verstärkt . 
schliessen_s27804_f0	Stuttgarter 	schließen 	Beherrschungsvertragkeywordtag mit der Mutter 
schliessen_s28271_f0	Nach dem Auslaufen des letzten Übergangsetats am Dienstag wurden etwa 800 000 Bundesangestellte in unbezahlten Zwangsurlaub geschickt , verschiedene Bundesbehörden blieben 	geschlossen 	. 
schliessen_s28279_f0	Am frühen Donnerstag morgen wurden die Einwohner in Kamen aufgefordert , Fenster und Türen 	geschlossen 	zu halten , Klimaanlagen abzustellen und die Häuser nicht zu verlassen . 
schliessen_s28504_f0	Die 33 000 Wahlbüros öffneten um acht Uhr und sollen um 19 Uhr 	schließen 	. 
schliessen_s28578_f0	Wegen des großen Wählerandrangs waren die Wahllokale nach Angaben des Innenministeriums in einigen Städten erst ein bis zwei Stunden später als geplant 	geschlossen 	worden . 
schliessen_s28600_f1	Der `` Trick '' dabei , wie Vogt erläutert : Die Verträge , die 1974 von Mohndruck und der IG Druck & Papier 	geschlossen 	wurden , hält die Geschäftsführung für gegenstandslos . 
schliessen_s28638_f0	Der Zweikampf zwischen dem charismatischen einzelnen und dem Volk fällt aus , alle sind ausgeliefert , nachdem Guiskardkeywordtag den eisernen Deckel des einzigen Ausstiegs 	geschlossen 	hat . 
schliessen_s29193_f0	Claus Peymann : Das Burgtheater war eine Zeitlang 	geschlossen 	. 
schliessen_s29519_f0	`` Die Höfe verschwinden zusehends , der Nachwuchs hat keine Lust mehr , sich abzurackern und die Landwirtschaftsschule können wirkeywordtag 	schließen 	'' , sagt Ekkehard Löhle , der Vizepräsident des Badisch Landwirtschaftlichen Hauptverbandes . 
schliessen_s30132_f1	Beide geben den Widerstand von Aktionären als Grund dafür an , daß die Ehe nicht 	geschlossen 	wird . 
schliessen_s30927_f1	Zahlreiche Behörden blieben 	geschlossen 	. 
schliessen_s31437_f0	Adidaskeywordtag 	schlossen 	so mit 76 Mark . 
