signalisieren_s2752_f1	Der Zweimonatsvergleich ( April / Mai gegenüber Februar / März ) , der die kurzfristigen Zufallsschwankungen zum Teil ausgleicht , 	signalisiert 	indessen eine deutliche Zurückhaltung . 
signalisieren_s3125_f1	Premier Major hatte am Wochenende bereits 	signalisiert 	, daß London sich um eine solche drastische Kostensenkung bemühen werde . 
signalisieren_s6060_f1	Durch ein diplomatisches Wunder , oder durch transpolitisches Eingreifen ... Vokalwerke mit Titeln wie Ein Schmetterlingstraum ( 1968 ) , An der Schwelle ( 1975 ) oder Der weise Mann ( 1977 ) 	signalisieren 	, daß bei Isang Yun platte Politisierung und Agitprop nie zu erwarten , im Gegenteil : strikt ausgeschlossen waren . 
signalisieren_s7130_f1	Der jährliche Anstieg der Verbraucherpreise - 2,1 Prozent im September - 	signalisiert 	keinerlei Inflationsgefahr . 
signalisieren_s7735_f1	Daher habe man die europäischen Verbündeten durch die Nominierung des bis dahin nur inoffiziell kandidierenden Lubbers in die Pflicht nehmen wollen - vor allem Bundeskanzler Helmut Kohl , derkeywordtag trotz anfänglichen Zögerns sein Votum für den Holländer 	signalisiert 	hatte . 
signalisieren_s10599_f1	Nur zähneknirschend wurde ihmkeywordtag bisher dazukeywordtag vom rechtsliberalen Flügel des Regierungslagers Zustimmungkeywordtag 	signalisiert 	. 
signalisieren_s10703_f1	Auch aus Bremen , Schleswig-Holstein und Hessen wurde Zustimmungkeywordtag 	signalisiert 	. 
signalisieren_s11092_f1	Lacherkeywordtag 	signalisierte 	, daß er gegen die Entscheidung Einspruch einlegen werde . 
signalisieren_s11237_f1	Unterdessen hat der amtierende israelische Regierungschef Peres gegenüber Syrien die Bereitschaft 	signalisiert 	, die Friedensverhandlungen baldmöglichst wiederaufzunehmen . 
signalisieren_s12153_f1	Für Büschgen 	signalisieren 	Entscheidungen deutscher Banken für Investmentbanking an der Themse das Akzeptieren `` höherer Leistungsfähigkeit und größeren Bedeutungsgewichts Londons und können damit Resignation für den Finanzplatz Frankfurt bedeuten '' . 
signalisieren_s12440_f1	Acht Vertreter 	signalisierten 	ihren Unmut über die Entscheidung , darunter auch die Grünen , die mit Clintons Umweltpolitik nicht zufrieden sind . 
signalisieren_s12545_f1	Der aufwendige Ausbau am Kontrollpunkt Erez 	signalisiert 	, daß sich auf mittlere Sicht hieran nichts ändern soll . 
signalisieren_s17026_f1	Daskeywordtag 	signalisieren 	jedenfalls zahlreiche Anrufe besorgter französischer Hoteliers , die das Ausbleiben der Buchungen deutscher Veranstalter beklagen . 
signalisieren_s17078_f1	Zum Programm gehört das `` Anzünden '' des Winters , wo nach einem Feuerwerk alle Lichter auf der Turrach angehen und so den Winterbeginn 	signalisieren 	. 
signalisieren_s20425_f1	Senator Bob Dole 	signalisierte 	inzwischen für die Republikaner bedingte Kompromißbereitschaft . 
signalisieren_s21275_f2	Der Gipfel müsse 	signalisieren 	, daß die führenden Politiker Europas Willen und Kraft hätten , die Wirtschafts- und Währungsunion als Stabilitätsgemeinschaft termingerecht zu verwirklichen . 
signalisieren_s22487_f1	Die vorliegenden Indikatoren `` 	signalisieren 	für die nahe Zukunft eine Abschwächung des Produktionswachstums auf hohem Niveau '' , beschreibt der Verband der Chemischen Industrie ( VCI ) die Lage . 
signalisieren_s24221_f1	Mit der Plazierung der Ordnungshüter auf den Kandidatenlisten will Cillerkeywordtag 	signalisieren 	, daß es im Kampf gegen die PKK keine Kompromisse und für die kurdischen Bürgerrechtler keine Zugeständnisse geben wird . 
signalisieren_s26138_f1	Steigende Preise für erschöpfbare und daher knappe Ressourcen 	signalisierten 	zunächst einmal nur die sichtbar gewordenen ökologischen Schranken des industriellen Wachstums , und zwar innerhalb von nationalstaatlich verfaßten Grenzen . 
signalisieren_s27497_f1	Zieht die Welt die Bilanz ihres Zustandes , diese Zahl , diekeywordtag den absoluten Tiefststand der Beachtung der Menschenrechte 	signalisiert 	, müßte Klarheit schaffen : fast 60 Millionen Flüchtlinge auf der Erde . 
signalisieren_s35862_f1	Mit dem Bombenanschlag gegen die ägyptische Botschaft in der pakistanischen Hauptstadt Islamabad haben die Moslem-Extremisten Ägyptens im Vorfeld der bevorstehenden Parlamentswahlen 	signalisiert 	, daß sie eine Kraft geblieben sind , um Staatspräsident Hosni Mubarak und seine Regierung zu bedrohen . 
signalisieren_s38216_f1	Die Zeiten-Wende 	signalisiert 	auch die Verabschiedung vom traditionellen Logo mit Turm und Brücke . 
signalisieren_s39093_f1	Unter anderen ist auch die Kranich-Linie bei Hapag noch mit 18 Prozent im Boot und hat Verkaufsbereitschaft zu einem angemessenen Preis 	signalisiert 	. 
signalisieren_s39607_f1	Der 70jährige Peter Wallenberg hat seinen Abgang 	signalisiert 	und Percy Barnevik , den Ex-Konzernchef von ABB , zu seinem Thronfolger bestellt . 
