ueberraschen_s1944_f1	Die gelegentlich schon erörterte Notwendigkeit der Einführung der Visumspflicht für `` Jugoslawen '' 	überraschte 	auch viele mit jugoslawischen Pässen ausgerüstete Angehörige anderer Republiken , die einmal zum alten Jugoslawien gehört hatten . 
ueberraschen_s5343_f3	Das kontroverse Echo , das das 350 Seiten dicke Buch `` Zukunft der Bildung . Schule der Zukunft '' ( erschienen bei Luchterhand ) auslöste , 	überraschte 	die Kommission . 
ueberraschen_s5531_f1	Daß Kwasniewski im ersten Wahlgang vorne liegt , kann nicht 	überraschen 	: 
ueberraschen_s6801_f1	Mit einer solchen Vertrauenserklärung , die noch in dieser Woche von der Finanzministerkonferenz vereinbart werden soll , sollten sich die Steuerzahler darauf verlassen können , `` daß siekeywordtag im nächsten Jahr nicht von einer Steuerveränderung zu ihrem Nachteil 	überrascht 	werden '' , erläuterte Waigel . 
ueberraschen_s7060_f1	Ichkeywordtag wäre sehr 	überrascht 	, sollte Fellini im Laufe seiner Karriere nicht immer wieder mit dieser Frage konfrontiert worden sein . 
ueberraschen_s7066_f1	Daß das wiederkehrende Motiv seiner Filme - La Dolce Vita , Satyricon usw. - immer das Zarte , das Lächerliche und Groteske , aber auch das Ausschweifende , das , Pathos ' von Leben und Tod sein würde , 	überraschte 	michkeywordtag nie . 
ueberraschen_s7817_f1	Kwasniewskikeywordtag zeigte sich von seinem Erfolg 	überrascht 	: 
ueberraschen_s8908_f2	Entscheidung zu Pille 	überrascht 	Gynäkologenkeywordtag 
ueberraschen_s11432_f1	Meiner Meinung nach liegen die Wurzeln mancher unguter Erscheinungen , diekeywordtag in unseren Gesellschaften auftreten und unskeywordtag immer wieder 	überraschen 	, in dem eben beschriebenen Zustand eines frustrierten postkommunistischen Gemüts . 
ueberraschen_s13466_f2	In Lüneburg waren die 3600 Studenten der dortigen Fachhochschule 	überrascht 	, als ihnen dieser Tage Bescheide auf scheinbar offiziellem Briefpapier über 1000 Mark Studiengebühren zugingen . 
ueberraschen_s15048_f2	Mankeywordtag sei von `` Ausmaß , Radikalität sowie Gedankenlosigkeiten '' 	überrascht 	'' worden . 
ueberraschen_s20037_f1	Daß unter den `` jungen Filmen '' Mathieu Kassovitz ' Hass siegte , konnte hingegen niemandenkeywordtag 	überraschen 	. 
ueberraschen_s22061_f1	Revelli , der nach enthusiastischen bis bösen Kritiken zu seinem im letzten Herbst erschienenen Buch in Norditalien herumgereicht wird , war vom methodologischen Ansatz wie vom Engagement der jungen Wissenschaftler angenehm 	überrascht 	. 
ueberraschen_s22065_f2	Nicht nur 	überraschte 	der starke Beifall , mit dem der unerwartete Schluß des jungen Turiner Zeitgeschichtlers Mantelli bedacht wurde , als er nach dem italienischen Politiker fragte , der , nach dem Beispiel Willy Brandts in Warschau , vor Denkmälern für die von Italienern zu verantwortenden Kriegsopfer in Zagreb oder Athen niederknien würde . 
ueberraschen_s22193_f1	dagegen 	überrascht 	die Galerie Schwind , Frankfurt a. M. , mit einem guten Querschnitt durch das Werk Wolfgang Mattheuers , der ja wohl doch der einzige Protagonist der Ost-Szene war , der über die alte Maniera zwanghafter deutscher Expressivität ( Dix und die Folgen ) oder Historienmalerei ( Tübke ) hinausgekommen ist . 
ueberraschen_s22421_f2	So quartiert sich der verlorene Sohn beim Vater ein , um ihnkeywordtag zu überraschen , will der Bruder den Bruder mit seiner Heirat von Tochter und Sohn versöhnen . 
ueberraschen_s22657_f1	`` Die Zahlen haben uns selbst 	überrascht 	'' , sagt Herbst . 
ueberraschen_s23093_f1	Der Gerügte seinerseits beteuerte am Sonntag , erkeywordtag sei von der Situation im Parlament nicht nur völlig 	überrascht 	worden , sondern auch in dem Glauben gewesen , er reagiere wunschgemäß . 
ueberraschen_s29101_f1	Der Eindruck 	überrascht 	und erschüttert zugleich . 
ueberraschen_s33693_f2		Überraschen 	mag , daß nach Ergebnissen der Umfragen die Religion des Kandidaten oder dessen Verbindungen zur Katholischen Kirche nur für vier Prozent der Polen wichtig sind . 
ueberraschen_s34869_f1	Waskeywordtag siekeywordtag am meisten 	überraschte 	, war die Feigheit der Angeklagten , deren Ausweichmanöver vor Gericht . 
ueberraschen_s36044_f2	Binnen weniger Tage indes bestimmte `` das Interview '' die Schlagzeilen der britischen Presse , rührte es royalistische Ängste und republikanische Hoffnungen auf und führte es zu hörbarem Zähneknirschen im Buckingham-Palast und im Rundfunkrat der BBC , dessen bei Hofe wohlgelittener Vorsitzender Sir Marmaduke Hussey von dem `` Panorama '' - Coup schmählich 	überrascht 	wurde . 
ueberraschen_s36963_f1	Wurde Ende November für 1998 ein Gewinn in zweistelliger Millionenhöhe avisiert , so 	überraschte 	der Vorstand gerade damit , dies schon im laufenden Turnus zu schaffen . 
ueberraschen_s37526_f1	Die jüngsten Signale von der Verkaufsfront haben Dieter Schüfer , Chef des Hausgeräte-Herstellers Leifheit ( Nassau / Lahn ) 	überrascht 	. 
ueberraschen_s37900_f1	IG Metall und Commerzbank von Vulkan-Desaster 	überrascht 	
