untersagen_s2458_f1	Die landwirtschaftliche Nutzung sei dort 	untersagt 	worden . 
untersagen_s2773_f1	In bestimmten Fällen kann das Arbeitsamt den Aufenthalt an fremden Gestaden auch 	untersagen 	, etwa dann , wenn während des Urlaubs mit der Vermittlung eines Arbeitsplatzes oder einer beruflichen Qualifizierung zu rechnen ist . 
untersagen_s6954_f1	Vom Meeresboden gekratzt werden die Wildmuscheln auch in der Schutzzone 1 des Nationalparks , wo Zutrittkeywordtag eigentlich strikt 	untersagt 	ist . 
untersagen_s9180_f1	Zeitgleich 	untersagte 	der Patriarch von Venedig , nachmals Papst Johannes XXIII. , seiner Gemeinde aus tiefer Sorge um Moral und Sittlichkeit den Biennale-Besuch . 
untersagen_s10816_f1	Die Nachfahren des berühmten Lakota-Indianers Crazy Horse wollen die Ausstrahlung eines Films über den Häuptling per Gericht 	untersagen 	lassen . 
untersagen_s10821_f1	Es muß der Unterhaltungsindustrie grundsätzlich 	untersagt 	werden , das Leben von Crazy Horse auszuschlachten . '' 
untersagen_s12166_f1	Die Kommission verweist ferner darauf , daß mehr als die Hälfte der gesamten Fördersumme auch fällig würde , wenn mankeywordtag die Privatisierung 	untersage 	- vor allem für Altlastensanierung , Abrißkosten und Sozialpläne . 
untersagen_s12935_f1	Die Behörde hatte der Organisation im September 1994 	untersagt 	, die TV-Übertragungsrechte an den Begegnungen weiter zentral zu vermarkten . 
untersagen_s15835_f1	In öffentlichen Gebäuden , in Büros , auf Flugplätzen und Bahnhöfen , in Schnellrestaurants und auch in vielen Teilen der Wirtschaft ist das Rauchen bereits 	untersagt 	. 
untersagen_s19276_f1	In öffentlichen Gebäuden , in Büros , auf Flugplätzen und Bahnhöfen und in Schnellrestaurants ist Rauchenkeywordtag 	untersagt 	. 
untersagen_s23558_f1	`` Die Rückkehr von Minderheiten war dabei 	untersagt 	'' , hieß es in Genf . 
untersagen_s25857_f1	Drei der landesweit fünf Polizeipräsidien 	untersagten 	jegliche Versammlungen rechtsextremer Vereinigungen am Volkstrauertag . 
untersagen_s28077_f1	Die Kläger von der Bürgerinitiative Helmstedt und der Umweltschutzorganisation Greenpeace wollen vor Gericht erreichen , daß das Umweltministerium in Magdeburg die weitere Einlagerung von Atommüll in der unterirdischen Deponie Morsleben 	untersagt 	. 
untersagen_s28135_f1	Das Magdeburger Oberverwaltungsgericht wies die Klagen von Umweltschützern ab , die Sachsen-Anhaltkeywordtag verpflichten wollten , dem Bund die Einlagerung radioaktiver Abfälle zu untersagen . 
untersagen_s28388_f1	Die Wettbewerbshüter hatten vor einem Jahr 	untersagt 	, daß TUIkeywordtag Hotels auf den Balearen und Kanaren allein für seine Kundschaft reserviert . 
untersagen_s28790_f1	Von der neuen Teilung des Kontinents sind besonders Menschen aus Albanien , Makedonien , Bulgarien , Rumänien , der Bundesrepublik Jugoslawien und der GUS , denenkeywordtag grundsätzlich die Einreise nach Schengenia 	untersagt 	wird , betroffen . 
untersagen_s32800_f1	Einen Job anzunehmen , 	untersagt 	ihrkeywordtag das höfische Protokoll : 
untersagen_s37944_f1	Derzeit könne eine Quersubventionierung bei der Standardauskunft zwar nicht 	untersagt 	werden , da diese als `` Pflichtleistung '' im öffentlichen Infrastrukturinteresse `` an besonderen sozialen Komponenten zu messen '' sei . 
untersagen_s37981_f1	Danachkeywordtag sind Ermäßigungenkeywordtag 	untersagt 	, wenn sie drei Prozent überschreiten und bestimmten Verbrauchergruppen gewährt werden . 
untersagen_s38770_f1	IG Metall und Betriebsrat wollen Alcatel SEL vom Arbeitsgericht die Aufgabe des Werks und die Unterschreitung der Zahl von 410 Arbeitsplätzen sowie Interessensausgleichsverhandlungen mit dem Ziel der Stillegung und von Kündigungen 	untersagen 	lassen . 
untersagen_s39665_f1	So soll bereits der Abschluß von Kartellverträgen 	untersagt 	werden und nicht erst die Anwendung . 
