unterstuetzen_s19_f1	Allerdings gibt es dem Magazin zufolge in kleinen und mittleren Firmen viele Unternehmer , die meinen , Perot sei einer von ihnen , und diekeywordtag den Texaner 	unterstützen 	. 
unterstuetzen_s744_f2	Die Offerte mit Geldgebern aus der Schweiz , Österreich , Japan und Großbritannien wurde vom adidas-Management geschlossen 	unterstützt 	und sah eine Kapitalspritze für das Unternehmen vor . 
unterstuetzen_s952_f1	Er warf der Regierung auch wieder vor , siekeywordtag 	unterstütze 	die Zulubewegung Inkatha , um den ANC zu schwächen . 
unterstuetzen_s1517_f2	Die Bundesregierung will offenbar die Forderung Rußlands nach Erleichterungen bei den Auslandsschulden 	unterstützen 	. 
unterstuetzen_s1673_f2	`` Herr Stolpe , 	unterstützen 	Siekeywordtag Industrieansiedlung auch in Premnitz '' , steht auf einem weiteren Transparent . 
unterstuetzen_s1785_f1	Wolf forderte die G-7-Regierungen auf , die Reformstaaten beim Aufbau eines leistungsfähigen öffentlichen Sektors zu 	unterstützen 	. 
unterstuetzen_s1978_f1	Wolf forderte die G-7-Regierungen auf , die Reformstaaten beim Aufbau eines leistungsfähigen öffentlichen Sektors zu 	unterstützen 	, statt nur `` Crash-Programme der Privatisierung zu betreiben . 
unterstuetzen_s2515_f2	In Phalempin auf der Fernstraße Lille - Paris , die seit einer Woche gesperrt ist , gingen rund 500 Polizistenkeywordtag 	unterstützt 	von gepanzerten Fahrzeugen gegen die Demonstranten vor , die die Einführung eines Strafpunktesystems für Verkehrssünder verhindern wollen . 
unterstuetzen_s4405_f2	Die Bemühungen der Hilfsorganisationen vor Ort müßten von allen 	unterstützt 	werden , sagte er . 
unterstuetzen_s4560_f1	Diese Versammlung muß der israelischen Bevölkerung , den Juden in der ganzen Welt und vielen in der westlichen Welt sowie anderswo deutlich machen , daß die Menschen in Israel Frieden wollen und den Frieden 	unterstützen 	. 
unterstuetzen_s4685_f1	Der Vorsitzende des oppositionellen Likud-Blocks , Benjamin Netanjahu , sagte im Fernsehen , seine Fraktion werde Pereskeywordtag 	unterstützen 	, da in einer Demokratie eine Regierung durch Wahlen `` und nicht durch Mord '' geändert werde . 
unterstuetzen_s5201_f1	Nur wenn die soziale und demokratische Gestaltung der Europäischen Union gelingt , werden die Menschen auch die politische Union 	unterstützen 	. 
unterstuetzen_s6397_f1	Das Mittel mit dem Namen Campral 	unterstütze 	die Therapie , indem es Entzugssymptome unterdrücke , sagte ein Firmensprecher am Montag . 
unterstuetzen_s6734_f1	Um dem steigenden Anteil von Dosenbier zu begegnen , ist nach Darstellung des Bundesverbands mittelständischer Privatbrauereien , derkeywordtag die BUND-Kampagne 	unterstützt 	, eine Einwegsteuer auf die Blechverpackung notwendig . 
unterstuetzen_s6827_f1	Zu denen , diekeywordtag die Indianer und Inuit 	unterstützen 	, gehört auch die `` Gesellschaft für bedrohte Völker '' . 
unterstuetzen_s7537_f2	Der ohne Koalitionsaussage geführte Wahlkampf 	unterstützte 	die mangelnde Orientierung . 
unterstuetzen_s7636_f1	Wie der Armeerundfunk meldete , soll erkeywordtag Jigal Amir bei der Planung der Tat 	unterstützt 	haben . 
unterstuetzen_s7828_f1	Führende Politiker der UW , darunter ihr Gründer Tadeusz Mazowiecki , der jetzige Vorsitzende und Wirtschaftsreformer Leszek Balcerowicz sowie der bekannte Historiker und UW-Fraktionschef Bronislaw Geremek , hatten noch am Wahlabend erklärt , daß die Partei in der zweiten Runde Lech Walesa 	unterstützen 	würde . 
unterstuetzen_s8173_f1	Erkeywordtag kündigte an , in der Stichwahl Walesakeywordtag 	unterstützen 	zu wollen . 
unterstuetzen_s8704_f2	DPS-Wahlhelferkeywordtag hätten im Romaviertel von Kardschali lediglich armen Familien Sozialhilfe gezahlt und einen Kindergarten sowie einen Fußballverein 	unterstützt 	. 
unterstuetzen_s10308_f1	Lediglich die Skandinavier 	unterstützten 	den dänischen Oppositionschef Uffe Ellemann-Jensen , der aber bereit ist , einem Mehrheitsfavoriten zu weichen . 
unterstuetzen_s10702_f2	die Hamburger Bürgerschaft beauftragte den Senat , den niedersächsischen Vorschlag zu unterstützen beziehungsweise eine ähnliche Bundestagsinitiative vorzubereiten . 
unterstuetzen_s10788_f1	Eskeywordtag soll 25 Jahre lang mit einem Zuschuß in Höhe von fünf Millionen Mark jährlich 	unterstützt 	werden . 
unterstuetzen_s11015_f1	Verheugen sagte dazu , nach dem Tod Rabins müsse Deutschlandkeywordtag den Friedensprozeß im Nahen Osten mit allen Kräften 	unterstützen 	. 
unterstuetzen_s12570_f1	Siekeywordtag 	unterstützt 	deshalb die in Gaza und im Westjordanland geplanten neun Industrieparks . 
unterstuetzen_s13989_f2	Sei es , durch Protestaktionen den eigenen Arbeitsplatz zu sichern oder andere Streikende zu unterstützen . 
unterstuetzen_s14349_f1	Die jüngste Entscheidung der britischen Regierung , trotz der weltweiten Proteste gegen die französischen Atomversuche im Südpazifik das Atomtestprogramm des französischen Präsidenten Jacques Chirac zu billigen und zu 	unterstützen 	, hat die Anrainerländer des Südpazifiks fast ebenso stark erschüttert , wie die Atomexplosionen im brüchigen Basalt-Sockel der Koralleninsel Mururoa selbst . 
unterstuetzen_s15011_f1	Der Wirtschaftsminister begrüßte die Initiative `` Bündnis für Arbeit '' des IG-Metall-Vorsitzenden Klaus Zwickel , weil damit erstmals der Zusammenhang zwischen Löhnen und Beschäftigung ausdrücklich anerkannt und die Eingliederung von Langzeitarbeitslosen durch untertarifliche Bezahlung 	unterstützt 	werde . 
unterstuetzen_s15231_f1	Die EKD wird das Hamburger Blatt pro Jahr jeweils mit neun Millionen Mark 	unterstützen 	. 
unterstuetzen_s15525_f1	Der neue Beamtenbund-Chef 	unterstützte 	den Plan Kanthers , die Besoldung künftig stärker an der Leistung und nicht mehr nur am Dienstalter auszurichten . 
unterstuetzen_s15888_f1	Siekeywordtag 	unterstütze 	zudem Beschlüsse der Städtetage , Verfassungsbeschwerden von Mitgliedsstädten in Baden-Württemberg und Schleswig-Holstein mitzutragen . 
unterstuetzen_s15891_f1	Andernfalls wollte die SPD die für den 16. November geplante Wahl von drei CDU-Kandidaten für den hauptamtlichen Magistrat nicht 	unterstützen 	. 
unterstuetzen_s15966_f1	Der Fraktionschef der Bündnisgrünen , Joschka Fischer , 	unterstützt 	die Initiative , hat aber aus taktischen Gründen - `` Sonst heißt es nur noch , das ist der Fischer-Antrag '' - nicht unterschrieben . 
unterstuetzen_s15977_f1	Bewohner , die diesen Preis nicht zahlen können , sollen etwa durch Wohngeld entsprechend ihres Einkommens 	unterstützt 	werden . 
unterstuetzen_s16147_f1	Washington habe wissen lassen , daß eskeywordtag Lubberskeywordtag nicht 	unterstützen 	wolle , sagte am Freitag Außenminister Hans van Mierlo in Den Haag . 
unterstuetzen_s16152_f1	Lubberskeywordtag war von zwölf der 16 Nato-Staaten 	unterstützt 	worden , darunter Frankreich , Großbritannien und Deutschland . 
unterstuetzen_s16626_f1	Es geht vielmehr darum , den Partei- und Fraktionsvorsitzenden darin zu 	unterstützen 	, die von ihm richtig gestellten Fragen in das Bewußtsein der gesamten Partei zu heben und die sich abzeichnenden Konturen einer modernen , also sozialdemokratischen Wirtschaftspolitik weiter zu schärfen . 
unterstuetzen_s17860_f1	Ihr Problem sind nicht in erster Linie fehlende Konzepte , sondern liegt in der Frage , werkeywordtag diese Konzepte eigentlich 	unterstützen 	und tragen soll . 
unterstuetzen_s18837_f2	&bullet; Die Geldpolitik der Europäischen Zentralbank wird durch Ausgabendisziplin und Stetigkeit des Staatssektors 	nachhaltig 	unterstützt ; 
unterstuetzen_s19176_f1	Die SPD 	unterstütze 	den China-Besuch Kohls , weil dieses Land nicht isoliert werden dürfe . 
unterstuetzen_s19742_f1	Nach der Ablehnung des Niederländers Ruud Lubbers als neuem Nato-Generalsekretär haben die USA am Wochenende indirekt zu verstehen gegeben , daß siekeywordtag auch die Kandidatur des Dänen Uffe Elleman-Jensen nicht 	unterstützen 	wollen . 
unterstuetzen_s20393_f1	Das Gros der sogenannten Illegalen werde meist von Verwandten und Freunden 	unterstützt 	und versuche , möglichst unauffällig einer Arbeit nachzugehen , sagte der Kriminologe Christian Pfeiffer aus Hannover . 
unterstuetzen_s20567_f1	Die IG Metall verspricht in einer Grußadresse , den neuen Verband zu 	unterstützen 	. 
unterstuetzen_s21232_f1	Die GTZ 	unterstützt 	derzeit im Auftrag Bonns 30 Projekte in Marokko mit jährlich rund 15 Millionen Mark . 
unterstuetzen_s21561_f1	Dagegen hat sich die mitregierende Bauernpartei , der Koalitionspartner von Kwasniewskis Demokratischer Linksallianz , noch nicht festgelegt , welchen Kandidaten siekeywordtag am 19. November 	unterstützen 	will . 
unterstuetzen_s21943_f1	Finanziell 	unterstützt 	von der Osnabrücker Bundesstiftung Umwelt , verschiedenen Landeskirchen sowie dem Diakonischen Werk , will eskeywordtag `` die Kirchen ermutigen , mit praktischen Schritten bei der Bewahrung der Schöpfung ernst zu machen und ihren Energieverbrauch beträchtlich zu verringern '' , wie Jobst Kraus von der Evangelischen Akademie Bad Boll sagt . 
unterstuetzen_s22564_f1	Fast genauso viele erklären , siekeywordtag würden vom Staat 	unterstützt 	. 
unterstuetzen_s22588_f1	So würden Projektekeywordtag vom Staat und durch Spenden aus dem `` Business '' 	unterstützt 	. 
unterstuetzen_s22594_f1	Einen guten Ruf hat sich in Rußland das 1992 gestartete Tacis-Demokratie-Programm der Europäischen Union erworben , daskeywordtag den Aufbau demokratischer Gesellschaften in den Ländern der ehemaligen Sowjetunion 	unterstützen 	soll . 
unterstuetzen_s22639_f1	Zwar dementierte der ehemalige palästinensische Chefunterhändler bei den Nahost-Friedensgesprächen , Haider Abd el-Shafi , Hamas habe ihn angesprochen , eine gemeinsame Partei zu gründen ( 25 Prozent würden diesekeywordtag 	unterstützen 	) , sagte aber : 
unterstuetzen_s22740_f1	Deshalb würden die Bemühungen der Bundesregierung 	unterstützt 	, heißt es in dem Papier , eine EU-weite , verbindliche Regelung zu erreichen . 
unterstuetzen_s22876_f2	Ziel sei es , so heißt es in der Gründungs-Präambel , `` eine aktive Gleichstellungs- und Antidiskriminierungspolitik in NRW durchzusetzen , diekeywordtag den emanzipatorischen Prozeß der Selbstorganisation von Migrantinnen , schwarzen Deutschen und anderen ethnischen Minderheiten 	unterstützt 	und die politische , wirtschaftliche , kulturelle und rechtliche Gleichstellung und Chancengleichheit befördert '' . 
unterstuetzen_s22957_f1	Der SPD-Vorstand legte am Montag einen Text vor , der den Titel `` Wirkeywordtag 	unterstützen 	den Friedensprozeß im ehemaligen Jugoslawien '' trägt und vom Parteitag , der am heutigen Dienstag in Mannheim beginnt , bestätigt werden soll . 
unterstuetzen_s22963_f1	Die Bundesrepublik werde die militärische Sicherung eines Friedensabkommens `` durch Sanitäter , Pioniereinheiten , Logistiktruppen , Transport- und Aufklärungsflugzeuge 	unterstützen 	'' . 
unterstuetzen_s23187_f1	Nach medico-Angaben hatten aber nur deutsche Gruppen , mehr als 100 an der Zahl , die geplante Demonstration 	unterstützt 	. 
unterstuetzen_s24465_f1	Lamfalussy sagte , erkeywordtag 	unterstütze 	voll die Motivation hinter dem Vorschlag von Bundesfinanzminister Theo Waigel , einen Stabilitätspakt für Europa zu schließen . 
unterstuetzen_s24608_f1	Der Bundesverband deutscher Banken 	unterstützt 	die Mahnung zu `` fundamentalen Korrekturen '' , betont aber , daß ein Aufschub der Europäischen Währungsunion das gesamte Projekt in Frage stellen würde . 
unterstuetzen_s24885_f1	Der Präsident der Bundesvereinigung der Deutschen Arbeitgeberverbände , Klaus Murmann , ließ verlauten , erkeywordtag 	unterstütze 	die Entscheidung für Stumpfe . 
unterstuetzen_s25124_f1	So 	unterstützt 	die Union etwa die Produktion von Dosen-Tomaten in Griechenland , Spanien und Italien . 
unterstuetzen_s25227_f1	HDE-Präsident Hermann Franzen wies Bohl - 	unterstützt 	durch starken Beifall - darauf hin , `` daß die Versammlung eine weitgehende Liberalisierung als gegen den Mittelstand gerichtet bewertet '' . 
unterstuetzen_s26394_f1	Unterrichtssprache ist Englisch , Studienort soll diekeywordtag slowakischekeywordtag Komenius-Universitätkeywordtag sein , eine Hochschule mit gutem Ruf , 	unterstützt 	von Forschungseinrichtungen wie dem Deutschen Akademischen-Austauschdienst ( DAAD ) , der Deutschen Forschungsgemeinschaft ( DFG ) und der Alexander-von-Humboldt-Stiftung . 
unterstuetzen_s27339_f1	Die Kirche werde siekeywordtag dabeikeywordtag `` gewiß 	unterstützen 	'' . 
unterstuetzen_s27697_f1	Lafontainekeywordtag 	unterstützte 	am Mittwoch die Auffassung des früheren EU-Kommissionspräsidenten Jacques Delors , der eine Europäische Wirtschaftsregierung für notwendig hält , um in der Währungsunion auch eine Politik für Arbeitnehmer machen zu können . 
unterstuetzen_s27837_f2	In einem posthum veröffentlichten Interview hatte der gehenkte Autor Ken Saro-Wiwa Shellkeywordtag vorgeworfen , den `` Völkermord '' des Regimes an dem Volk der Ogoni , das an der Flußmündung lebt , zu unterstützen . 
unterstuetzen_s27976_f1	Der WWF setzt sich für eine Nutzung der Arten ein , die deren Bestand nicht gefährdet , und 	unterstützt 	Forscherkeywordtag bei der Suche nach Ersatzstoffen . 
unterstuetzen_s28044_f1	Dazu gehöre auch , daß die Partei Lafontainekeywordtag uneingeschränkt 	unterstütze 	. 
unterstuetzen_s28114_f1	Die Länder sollen die Gemeinden dabeikeywordtag sowohl fachlich als auch finanziell 	unterstützen 	. 
unterstuetzen_s28498_f1	Mit nahezu 90 Millionen Mark wird Bonnkeywordtag im kommenden Jahr Projekte in Rußland 	unterstützen 	, die dort den Verbleib von Rußlanddeutschen fördern sollen . 
unterstuetzen_s28911_f1	Daß ihnkeywordtag SPÖ , Grüne oder Liberales Forum dabeikeywordtag 	unterstützen 	könnten , ist ausgeschlossen . 
unterstuetzen_s28984_f1	Eingespeist werden soll diese Elektrizität ins Netz der Freiburger Energieversorgungsgesellschaft , diekeywordtag das Projekt 	unterstützt 	. 
unterstuetzen_s29065_f1	Liegen die `` Großen '' im Konflikt , 	unterstützt 	Luxemburgkeywordtag die `` europäischste Lösung '' . 
unterstuetzen_s29342_f1	Grosse-Brockhoff hat das , wie berichtet , kürzlich praktisch vorgeführt , als erkeywordtag vorbehaltlos den Vorschlag der Veba 	unterstützte 	, auf dem städtischen Gelände im Ehrenhof einen Gebäudekomplex zu errichten , der neben einem Ausstellungsraum und einem Konzertsaal riesige Büroflächen der Kommunikationswirtschaft beherbergen soll . 
unterstuetzen_s29423_f1	In der Landwirtschaft 	unterstütze 	ichkeywordtag das vertragsgebundene System der Verantwortung für ein großes Stück Land . 
unterstuetzen_s30267_f2	Also stellt er sich in den Dienst des Großen und Ganzen , was in diesem Fall die Sozialdemokratie ist , und fordert die ganze Partei auf , `` Oskar Lafontaine uneingeschränkt zu unterstützen '' . 
unterstuetzen_s30564_f1	Die Pharmaindustrie , diekeywordtag Präsident Chiracs Wahlkampf massiv 	unterstützt 	hatte , wird 1996 mit einem provisorischen Sonderbeitrag in Höhe von 2,5 Milliarden Francs zur Kasse gebeten werden . 
unterstuetzen_s30647_f1	Der politische Aufstieg des Oskar Lafontaine , derkeywordtag aus einer saarländischen Arbeiter- und Handwerkerfamilie stammt , als Schüler und Student aus Mitteln der katholischen Kirche 	unterstützt 	wurde , begann 1966 . 
unterstuetzen_s30738_f2	Scharping , der sich anschließend zu einem der fünf stellvertretenden SPD-Vorsitzenden wählen ließ , forderte die Partei ebenfalls auf , Lafontainekeywordtag `` uneingeschränkt zu unterstützen '' . 
unterstuetzen_s30835_f1	Mit der langfristigen Regelung wollten die Kreditinstitute die Reformbemühungen Moskaus 	unterstützen 	. 
unterstuetzen_s30848_f1	Viele SPD-Stadtverordnete 	unterstützten 	Glaserkeywordtag nicht , weil er erklärt hatte , der Kampf für gewerbliche Arbeitsplätze in Frankfurt lohne nicht . 
unterstuetzen_s31129_f1	Mit großer Mehrheit haben die Mitgliedsstaaten der Vereinten Nationen am Donnerstag eine Resolution gegen die französischen Atomtests im südlichen Pazifik 	unterstützt 	. 
unterstuetzen_s31283_f2	Vor mehreren tausend Studenten der Universität in Hanoi sagte Kohl : `` Wirkeywordtag sind gerne bereit , Siekeywordtag auf Ihrem gewiß nicht leichten Weg nach Kräften zu unterstützen . '' 
unterstuetzen_s31323_f1	Die Protestbewegung wird von Hochschullehrern 	unterstützt 	. 
unterstuetzen_s31399_f1	Dieskeywordtag werde von den USA aber nicht 	unterstützt 	, hieß es in den Kreisen . 
unterstuetzen_s31827_f1	Die Wirtschaftsminister der entsprechenden Länder sind begeistert und 	unterstützen 	das Regionalisierungskonzept auch finanziell durch eine `` Promotions-Gebühr '' . 
unterstuetzen_s31971_f1	So nennt sich ein Verein , derkeywordtag , 	unterstützt 	vom Kultusministerium in Schwerin , den Kulturtourismus in Mecklenburg-Vorpommern fördern will . 
unterstuetzen_s33369_f2	Dilma Felizardo , Initiatorin des Casa Renascer ( `` Haus der Wiedergeburt '' ) im nordbrasilianischen Natal , ist Koordinatorin einer internationalen Kampagne gegen den Kindersextourismus in Brasilien , diekeywordtag unter anderem von dem in Kassel ansässigen Verein `` Human Care '' 	unterstützt 	wird . 
unterstuetzen_s33692_f1	In der Gunst der Privatunternehmer liegt der amtierende Präsident vorne , Arbeitslosekeywordtag 	unterstützen 	mit großer Mehrheit Kwasniewskikeywordtag . 
unterstuetzen_s33714_f1	`` Die Bundesrepublik wird die militärische Sicherung des Friedensabkommens durch Sanitäter , Pioniereinheiten , Logistik-Truppen , Transport- und Aufklärungsflugzeuge 	unterstützen 	'' , heißt es weiter . 
unterstuetzen_s33719_f2	Der saarländische Ministerpräsident warb noch einmal um Verständnis für den überraschenden Führungswechsel in der SPD und rief alle Mitglieder auf , den `` Neubeginn zu unterstützen '' . 
unterstuetzen_s34001_f1	Diese müssen erkennen , daß die Bevölkerung siekeywordtag nicht 	unterstützt 	. 
unterstuetzen_s34210_f2	Der saarländische Ministerpräsident warb um Verständnis für den überraschenden Führungswechsel in der SPD und rief alle Mitglieder auf , den `` Neubeginn zu unterstützen '' . 
unterstuetzen_s34389_f1	Das Projekt wird auch von der Deutschen Forschungsgemeinschaft und dem Bundesinnenministerium 	unterstützt 	. 
unterstuetzen_s34565_f1	Südafrikas Präsident Nelson Mandela rief die USA , Großbritannien und China auf , ein Ölembargo gegen Nigeria zu 	unterstützen 	. 
unterstuetzen_s34785_f1	Um in diesem Rennen zu siegen , müssen die Staaten und Arbeitnehmer `` ihre '' Unternehmen 	unterstützen 	: durch Deregulierung und Flexibilisierung , durch `` maßvolle '' Löhne und Senkung der Lohnnebenkosten , durch niedrige Steuern und Umweltkosten - und auch durch hohe Subventionen . 
unterstuetzen_s35378_f1	Eine davon 	unterstützt 	etwa Schulen , erzählt Trondsen , denn `` der Erziehungssektor hält mit der technologischen Entwicklung nicht mit '' . 
unterstuetzen_s35547_f1	Seit Jahren ringen die alten und meist kranken rund 300 überlebenden Opfer der NS-Militärjustiz , 	unterstützt 	von Bündnisgrünen , SPD sowie PDS und blockiert von der Union , darum , daß der Bundestag die Urteile brandmarkt , sprich , den als `` Drückeberger '' Geächteten die verlorene Ehre wiedergibt . 
unterstuetzen_s35718_f1	Aber viele Polen haben Walesa wiedergewählt , weil siekeywordtag die Richtung der 1989 begonnenen Reformen 	unterstützen 	. 
unterstuetzen_s36184_f1	Der Kanzler 	unterstützt 	die deutsche Industrie bei ihrem Versuch , auf einem `` Zukunftsmarkt '' Fuß zu fassen , lautete die Botschaft dieser Übung . 
unterstuetzen_s36272_f1	Rund 1,3 Millionen 	unterstützen 	das Kirchenvolksbegehren 
unterstuetzen_s36434_f2	Südafrikas Präsident Nelson Mandela rief die USA , Großbritannien und China auf , ein Ölembargo zu unterstützen . 
unterstuetzen_s36870_f1	Das beginnt schon auf Seite zwei mit der fast rekordverdächtigen Verlustzuweisung von 233 Prozent auf die Zeichnungssumme , für alle diekeywordtag Prinz zu Hohenlohe etwa bei der Finanzierung seines `` Freizeitzentrums Schloß Blücher '' 	unterstützen 	. 
unterstuetzen_s37461_f1	Im Rahmen von Innovationsförderprogrammen wolle Bonnkeywordtag deshalb künftig auch Verbesserungen auf diesem Gebiet 	unterstützen 	. 
unterstuetzen_s37494_f1	Siekeywordtag werde die Agiv weiter 	unterstützen 	. 
unterstuetzen_s37715_f1	Rund 40 Unternehmen von Apple und Black Sun über IBM und Intel bis Oracle , Silicon Graphics und Sony 	unterstützen 	die Initiative . 
unterstuetzen_s37903_f1	Die IG Metall hat die Übernahme ehemaliger DDR-Werften durch den Bremer Vulkan zunächst weitgehend 	unterstützt 	. 
unterstuetzen_s38006_f1	Die Mehrheit der britischen Industrie 	unterstütze 	ohnehin den Euro . 
unterstuetzen_s38618_f1	Der Manager will Motivation und Gestaltungsfreiheit 	unterstützen 	und die innere `` Lähmung '' beseitigen . 
unterstuetzen_s38917_f1	`` Wir haben den Leuten gesagt : Wenn du für das Brot mehr bezahlst , 	unterstützt 	dukeywordtag damitkeywordtag auch jene Bauern in deiner Region , die ökologisch wirtschaften , und schützt damit deine unmittelbare Umwelt . '' 
