verdoppeln_s1097_f1	Der japanische Ausfuhrüberschuß im Handel mit der Zwölfergemeinschaft hatte sich im vergangenen Jahr auf umgerechnet rund 40 Milliarden Mark 	verdoppelt 	. 
verdoppeln_s4800_f1	Der Preis der Körner 	verdoppelt 	sich fast auf dem Weg aus der Schweiz in die Union . 
verdoppeln_s4803_f1	Auch wenn dieser Fang eine Ausnahme blieb , so hat sich die beschlagnahmte Menge im laufenden Jahr im Vergleich zur Vorperiode bereits auf elf Tonnen 	verdoppelt 	. 
verdoppeln_s8277_f1	Mit 3,4 Milliarden Mark Gewinn vor Ertragsteuern in den ersten neun Monaten wurde das entsprechende Ergebnis im Vergleichszeitraum ' 94 glatt 	verdoppelt 	. 
verdoppeln_s8373_f1	`` Wirkeywordtag müssen unsere Anstrengungen 	verdoppeln 	. 
verdoppeln_s9903_f1	Der Inhalt der Kriegskasse hat sich im vergangenen Geschäftsjahr 1994/95 per Ende Juni auf netto 1,5 Milliarden Mark 	verdoppelt 	. 
verdoppeln_s11708_f1	Bei Studierenden , die unteren Einkommensschichten entstammen und deshalb den Höchstsatz an Bafög erhalten , würde sich die Schuldenlast im Vergleich zu heute auf bis zu 70 000 Mark 	verdoppeln 	. 
verdoppeln_s12528_f1	In anderthalb Jahrzehnten wird sich die Bevölkerung 	verdoppeln 	. 
verdoppeln_s14192_f1	Nach früheren Angaben will der Filialist den Umsatz in diesem Jahr auf 300 Millionen Mark mehr als 	verdoppeln 	. 
verdoppeln_s14870_f1	Siekeywordtag 	verdoppeln 	ihre Rückstellungen auf 60 bis 70 Millionen Mark . 
verdoppeln_s15294_f1	Im dritten Quartal wurde der Gewinn auf fast 1,1 Milliarden `` nur '' 	verdoppelt 	. 
verdoppeln_s17835_f1	Hier hat sich die Zahl der Beschäftigten zwischen 1960 und 1993 	verdoppelt 	bis verdreifacht . 
verdoppeln_s19941_f1	In allen europäischen Ländern , folglich auch in Deutschland , müssen die privaten Forschungsausgaben 	verdoppelt 	werden . 
verdoppeln_s20963_f1	In den letzten Jahren hat sich nach Angaben der Juristen die Zahl der jährlich neu eingehenden Verfahren mehr als 	verdoppelt 	. 
verdoppeln_s21403_f1	Die Zahl der unter 18jährigen Straftäter für dieses Delikt habe sich von 1985 bis 1993 auf 61 000 	verdoppelt 	. 
verdoppeln_s22031_f1	Nach dem Erwerb wird sich der Umsatz von Mühl im kommenden Jahr auf 600 Millionen Mark 	verdoppeln 	. 
verdoppeln_s24374_f1	Im laufenden Jahr soll sich die Beschäftigtenzahl auf hundert 	verdoppeln 	und der Umsatz auf zwölf Millionen Pfund ( knapp 27 Millionen Mark ) vervierfachen . 
verdoppeln_s26006_f1	Der Chemiekonzern plant , seinen Umsatz im Reich der Mitte bis zur Jahrtausendwende auf 1,2 Milliarden Dollar zu verdoppeln . 
verdoppeln_s27932_f1	In den vergangenen fünf Jahren hat sich weltweit die Zahl der anerkannten Flüchtlinge 	verdoppelt 	. 
verdoppeln_s28108_f1	Bei einer Erhöhung um zehn Dezibel 	verdoppelt 	sich der Lärm . 
verdoppeln_s28311_f1	In der laufenden Periode wollen die Bayern erneut um eine Milliarde wachsen , bis zur Jahrtausendwende den Umsatz 	verdoppeln 	. 
verdoppeln_s28500_f1	Rußlandkeywordtag will seine Hilfe 1996 auf 30 Millionen Mark 	verdoppeln 	. 
verdoppeln_s29917_f1	Die FT-Publikumsfonds 	verdoppelten 	im Geschäftsjahr per Ende September den Absatz auf 1,6 Milliarden Mark , wobei der Geldmarktfonds Accugeld der Renner war . 
verdoppeln_s31183_f1	Die Käufer des umstrittenen Software-Bestsellers SoftRAM 95 , derkeywordtag angeblich den Hauptspeicher eines Personal Computers 	verdoppelt 	, sollen auch in Deutschland ihr Geld zurückbekommen , wenn sie mit dem Produkt nicht zufrieden sind . 
verdoppeln_s36517_f1	`` Warum nehmen die Anlageinvestitionen nur um 1,5 Prozent zu , wo sich doch der Zuwachs der Unternehmens- und Vermögenseinkommen auf sieben Prozent mehr als 	verdoppelt 	? '' will der Wirtschaftssprecher ihrer Fraktion , Ernst Schwanhold , wissen . 
verdoppeln_s38259_f1	Der Börsenwert hat sich 1996 fast 	verdoppelt 	auf 42 Milliarden Mark . 
verdoppeln_s39219_f1	VW-Tochterkeywordtag möchte Produktionkeywordtag 	verdoppeln 	
verdoppeln_s39223_f1	Die Volkswagen-Tochter will die Autoherstellung bis zur Jahrtausendwende nahezu 	verdoppeln 	. 
verdoppeln_s39868_f1	Daß die lineare Abschreibung auf vier Prozent 	verdoppelt 	wird , wie manche fordern , hält sie für nicht durchsetzbar beim Finanzminister . 
