vergleichen_s6278_f1	Allen Roses von der Duke Universität in Durham ( US-Staat North Carolina ) 	verglich 	apo E in einem Bericht der Zeitung The Wall Street Journal mit einer Haushälterin . 
vergleichen_s8404_f1	Mit harter Kritik hat der stellvertretende SPD-Fraktionsvorsitzende Günter Verheugen auf Äußerungen von Generalinspekteur Klaus Naumann reagiert , derkeywordtag die jetzigen Auslandseinsätze der Bundeswehr mit der deutschen Beteiligung an zwei Kriegen 1900 in China und 1904 im ehemaligen Deutsch-Südwestafrika 	verglichen 	hatte . 
vergleichen_s8405_f1	Verheugen bezeichnete beide Kriege am Montag bei einem sicherheitspolitischen Kongreß des Deutschen Bundeswehrverbandes in Bonn als `` brutale Kolonialkriege '' , diekeywordtag zu den `` schmachvollen Kapiteln der deutschen Geschichte '' in diesem Jahrhundert zählten und deshalb nicht mit UN-Missionen in der heutigen Zeit 	verglichen 	gehörten . 
vergleichen_s10745_f1	Die Parteien der tamilischen Minderheit , von denen zwei an der Regierung beteiligt sind , 	verglichen 	in ihrer Erklärung verglichen sie die Situation von mehr als 500 000 Flüchtlingen im Norden Sri Lankas mit dem Bürgerkrieg in Bosnien . 
vergleichen_s11415_f1	Ichkeywordtag 	vergleiche 	diesen Zustand oft mit der Gemütsverfassung eines Menschen , der nach einer längeren Haft plötzlich freigelassen wird . 
vergleichen_s12733_f2	Beide wollen keinen Prozeß , aber siekeywordtag wollen sich auch nicht `` hindern '' lassen , Umfrageergebnisse und Wahlergebnisse zu vergleichen und politisch zu bewerten , wenn die `` Fakten einen bemerkenswerten Rekord an Irrtümern offenbaren '' . 
vergleichen_s13447_f1	Auch können für das Produkt nicht typische Eigenschaften miteinander 	verglichen 	werden . 
vergleichen_s14020_f1	Was verbindet , abgesehen von diesem zweifelhaften Bruderkuß , den mexikanischen Künstlerrevolutionär mit dem amerikanischen Kunstrevolutionär , daß siekeywordtag jetzt in einer großen Ausstellung in der Düsseldorfer Kunsthalle miteinander 	verglichen 	werden ? 
vergleichen_s14789_f1	Ihre Rede kommt gut an bei den verkopften Protestanten , weil siekeywordtag in Bildern erzählt , Europakeywordtag mit einer alten geflickten Decke ihrer Großmutter 	vergleicht 	und Gefühle offenbart . 
vergleichen_s15401_f1	Da mag der Literaturnobelpreisträger und nigerianische Landsmann Wole Soyinka in seinem Londoner Exil recht haben , wenn er die Versenkung der Ölplattform Brent Spar 	verglichen 	mit dem , was im Ogoni-Gebiet vor sich geht , `` eine Kleinigkeit '' nennt . 
vergleichen_s16483_f1	Erkeywordtag 	verglich 	die Kreszenzen der Elbregion mit denen von Rhein und Mosel , von Bordeaux und der Toskana . 
vergleichen_s17483_f1	Und während DRV-Präsident Gerd Hesselmann noch auf die Unvergleichbarkeit touristischer Leistungen verweist , fordern andere Branchenvertreter bereits eine CD-ROM , mit der sich die Preise der verschiedenen Veranstalter 	vergleichen 	lassen . 
vergleichen_s19044_f1	In Ostdeutschland sindkeywordtag die Lebenshaltungskosten binnen Jahresfrist um 2,6 Prozent geklettertkeywordtag 	verglichen 	mit 2,5 Prozent im September . 
vergleichen_s20288_f1	Helmut Kohl , erst kürzlich mit dem fernöstlichen Religionsstifter 	verglichen 	, weilt ab Montag wieder in Peking . 
vergleichen_s20644_f1	Es kann auch kein Zufall sein , daß die Stimme des Bürgermeisters sich selbst ausgerechnet mit USA Today 	vergleicht 	, einem ähnlich aufgemachten Blatt aus dem Land des Todfeinds Amerika . 
vergleichen_s22062_f1	Ich wußte von einem Auftritt Revellis in Turin , bei dem der Widerstand in Italien mit dem in Frankreich und Deutschland 	verglichen 	worden war , und bat ihn um sein Urteil . 
vergleichen_s22076_f1	Wenn Revellis Buch , daskeywordtag in Genua mit Remarques Im Westen nichts Neues 	verglichen 	wurde , im kommenden März in deutscher Übersetzung ( bei Beck ) erscheint , könnte das als Anlaß für analoge Aufklärungsaktionen zum italienisch-deutschen Verhältnis dienen . 
vergleichen_s24681_f1	Ichkeywordtag wage es , die Wirkung mit der eines Elektroschocks auf einen lebendigen Körper zu vergleichen : 
vergleichen_s29332_f1	In dem Zusammenhang wirkt es wie Hohn , daß Grosse-Brockhoffkeywordtag die ( auch ) kulturpolitische Entscheidungsunfähigkeit in unserer Gesellschaft mit dem sprichwörtlichen Esel 	vergleicht 	, der zwischen zwei Heuhaufen nicht wählen kann und deshalb verhungert . 
vergleichen_s30962_f1	Mankeywordtag vermißt Fußabdrücke und 	vergleicht 	Fraß- und Kotspuren , und so kommt man auf etwa 50 Individuen im westlichsten Landzipfel auf Westjava . '' 
vergleichen_s30984_f1	Der Arzt 	verglich 	die Trinkgewohnheiten von 340 Männern und Frauen , die alle einen Infarkt erlitten hatten , mit einer gesunden Testgruppe . 
vergleichen_s31155_f1	Seine Konstrukteure 	vergleichen 	ISOkeywordtag mit einer riesigen Thermosflasche , die Kaffee sechs Jahre lang warm halten könnte . 
vergleichen_s31646_f1	`` 	Verglichen 	mit Buenos Aires ist Santiagokeywordtag ein Friedhof '' , klagt ein deutscher Wirtschaftsexperte . 
vergleichen_s34118_f1	Hierkeywordtag halten sich dennoch , 	verglichen 	mit anderen europäischen Staaten , immer noch relativ wenige Nicht-EU-Ausländer ( `` Extracomunitari '' ) auf , nämlich 818 592 angemeldete und bis zu 800 000 illegal eingereiste . 
vergleichen_s35545_f1	Doch scheut auch er sich nicht , gegen die Rehabilitierung von Deserteuren mit dem Argument Stimmung zu machen , während des Zweiten Weltkriegs hätten alle Armeen in der Fahnenflucht ein Verbrechen gesehen - so , als sei die Flucht aus einem verbrecherischen Angriffskrieg eine Desertion wie andere und als ließe sich die Wehrmachtsjustiz mit den Militärgerichten anderer Staaten 	vergleichen 	. 
