verhandeln_s702_f1	Kasachenkeywordtag 	verhandeln 	über Ölfeld 
verhandeln_s2586_f1	Seit der Unabhängigkeit der Republik Irland , also seit 70 Jahren , ist es das erste Mal , daß die verschiedenen Parteien der nordirischen Unionisten offiziell mit der Dubliner Regierung 	verhandeln 	. 
verhandeln_s2713_f1	Ob und wann der Fall 	verhandelt 	wird , ist ungewiß . 
verhandeln_s2731_f1	Nur nach Genehmigung des Innenministers darf gegen die Folterknechte 	verhandelt 	werden , und auch dann nur unter Ausschluß der Öffentlichkeit . 
verhandeln_s3923_f1	Freunde Aristides hatten bekräftigt , daß der 1991 gestürzte Präsident nicht bereit sei , mit Bazin als Regierungschef zu verhandeln . 
verhandeln_s4137_f1	In Dayton 	verhandeln 	seit Mittwoch die Präsidenten Bosniens , Serbiens und Kroatiens über eine Friedenslösung für das ehemalige Jugoslawien . 
verhandeln_s4444_f1	In Kaschmir wird angeblich über Modalitäten für eine Freilassung der vor fünf Monaten entführten vier westlichen Touristen 	verhandelt 	. 
verhandeln_s4447_f1	Über die Art der Freilassung werde noch 	verhandelt 	, sagten Behördenvertreter . 
verhandeln_s6181_f1	Mortier hatte vor wenigen Tagen in einem Interview der Zeitschrift `` News '' angekündigt , erkeywordtag werde , wenn das Kuratorium den neuen Vertrag nicht am Dienstag billigen sollte , weiter mit Salzburg 	verhandeln 	, `` gleichzeitig aber auch mit anderen Partnern reden '' . 
verhandeln_s6182_f1	Er habe zwei Angebote , `` und über die 	verhandle 	ichkeywordtag ab 7. November , wenn die Verlängerung dann nicht stattfindet '' . 
verhandeln_s6633_f1	Neben Zaoui wird gegen vier weitere mutmaßliche GIA-Angehörige erneut 	verhandelt 	. 
verhandeln_s8265_f1	Über weitere Desinvestitionen werde zur Zeit 	verhandelt 	, berichtet Dormann . 
verhandeln_s8957_f1	Diese Frage wird am 21. November vor dem Bundesverfassungsgericht in Karlsruhe 	verhandelt 	. 
verhandeln_s9184_f1	Siekeywordtag 	verhandelt 	eines der düstersten Kapitel der jüngeren italienischen Geschichte , in dem Bajs eigene Biographie auf fatale Weise mit der Chronologie der Ereignisse verwoben ist . 
verhandeln_s10212_f1	Über die von der Union gewünschte Abschaffung oder Einengung der sogenannten `` geringfügigen Arbeitsverhältnisse '' , die sozialabgabefreien 580-Mark-Jobs , haben die Koalitionsvertreter in den Schlußrunden nicht 	verhandelt 	, die FDP sieht dabei `` keinen Handlungsbedarf '' . 
verhandeln_s10942_f1	Mit dem vom Landesausschuß geforderten Rücktritt der Senatoren sollte die Zusammenarbeit mit der CDU zunächst formell beendet werden , um dann über eine eventuelle Neuauflage der Koalition mit der CDU zu verhandeln . 
verhandeln_s12248_f1		Verhandelt 	werde über einen Preis von 400 bis 500 Millionen Dollar . 
verhandeln_s12664_f1	Daß die regionalen Milosevic-Statthalter entnervt nicht weiter 	verhandeln 	wollen und damit den Schwarzen Peter halten , hat aber wenig Bedeutung . 
verhandeln_s12687_f1	Der Ostdeutsche ist enttäuscht , daß die Bundesregierung es ablehnt , über Änderungen des Militärseelsorgevertrages von 1957 zu verhandeln . 
verhandeln_s13606_f1	Derzeit werde über den Verkauf des 1890 gegründeten Betriebes 	verhandelt 	. 
verhandeln_s13661_f1	Seit vorigem Mittwoch 	verhandeln 	Vertreter Serbiens , Bosniens und Kroatiens in Dayton ( Bundesstaat Ohio ) . 
verhandeln_s18864_f1	Es werde mit vier Kaufinteressenten 	verhandelt 	. 
verhandeln_s19407_f1	Er wolle keinen Druck auf das Bundesverfassungsgericht ausüben , beteuert der Bundesinnenminister - in einem Atmenzug mit den massiven , kaum verhohlenen Warnungen in Richtung Karlsruhe , wokeywordtag Ende November über das neue Asylrecht 	verhandelt 	wird . 
verhandeln_s20724_f1	Deswegen darf nur drei Stunden am Tag 	verhandelt 	werden . 
verhandeln_s20730_f1	Im grellen Lichte der nigerianischen Hinrichtungen ist auf dem Commonwealth-Gipfel in Neuseeland - begreiflicherweise - der Rest der Tagesordnung im Halbschatten 	verhandelt 	worden . 
verhandeln_s22353_f1	Darüberkeywordtag soll nun mit den verantwortlichen Politikern 	verhandelt 	werden . 
verhandeln_s22619_f1	Arafatkeywordtag 	verhandelt 	mit Hamas 
verhandeln_s23876_f1	BGHkeywordtag 	verhandelt 	erstmals über DDR-Todesurteile 
verhandeln_s24515_f1	Als wäre daskeywordtag nicht - mit einem schweren Versäumnis allerdings : an der Bevölkerung vorbei - jahrelang diskutiert und 	verhandelt 	, dann mit überwältigenden , parteiübergreifenden Mehrheiten beschlossen und letztlich verfassungsrechtlich geprüft worden ! 
verhandeln_s24718_f1	Dennoch haben die Palästinenser es bereits akzeptiert , darüberkeywordtag zu verhandeln , um einen Kompromiß zu erreichen . 
verhandeln_s26301_f1	Er muß vorbereitet werden auf die Teilnahme an einer Gesellschaft , in der über Werte 	verhandelt 	und entschieden wird . 
verhandeln_s28598_f1	Widersprüchliche Standpunkte also , die aber ein Licht auf die Situation bei den Mohndruckern werfen , und über die beim Termin am 23. November vor dem Arbeitsgericht Bielefeld 	verhandelt 	wird . 
verhandeln_s30010_f1	Während sein Stabschef Leon Panetta im Kongreß mit den Führern der Republikaner über einen Kompromiß 	verhandelte 	, verurteilte der Präsident im Stile des besorgten Landesvaters die Republikaner bei einer Pressekonferenz als Leute , die `` Ideologie über den gesunden Menschenverstand und die von allen geteilten Werte setzen '' . 
verhandeln_s30079_f1	Die Konzerne Boeing und McDonnell Douglas 	verhandeln 	über eine engere Kooperation , die zu einem Zusammenschluß der beiden großen Flugzeughersteller führen könnte . 
verhandeln_s30823_f1	Das grundsätzliche Abkommen , über das seit vier Jahren 	verhandelt 	worden war , wurde am Donnerstag abend in Frankfurt am Main von Repräsentanten beider Seiten unterzeichnet . 
verhandeln_s31484_f1	Der Westen und Rußland hatten bis zur letzten Minute vor Inkrafttreten des Vertrages 	verhandelt 	. 
verhandeln_s33472_f1	`` Wirkeywordtag haben lange 	verhandelt 	, um möglichst viel für die Mitarbeiter herauszuholen . '' 
verhandeln_s33532_f1	Über weitere Mittel wird mit dem Internationalen Währungsfonds ( IWF ) 	verhandelt 	. 
verhandeln_s33536_f1	darüberkeywordtag wird noch 	verhandelt 	. 
verhandeln_s33571_f1	Verteidigungsminister Rühe forderte , die Strukturreform der Nato sofort einzuleiten , um wie geplant 1997 mit den Reformstaaten Osteuropas über ihren Beitritt 	verhandeln 	zu können . 
verhandeln_s33904_f1	Erkeywordtag will weiter 	verhandeln 	, ließ aber keinen Zweifel daran , daß die Evangelische Kirche ganz im Sinne Luthers `` für die Freiheit aller '' - Gläubiger wie Nichtgläubiger - an Brandenburgs Schulen streiten werde . 
verhandeln_s34906_f1	Bis zu dem Tag , an dem das Massaker an mehr als 4000 polnischen Offizieren in einem Wald bei Katyn 	verhandelt 	wurde , war der Prozeß für sie so eine Art `` Jüngstes Gericht '' gewesen . 
verhandeln_s34910_f1	Doch so , wie Katynkeywordtag in Nürnberg dann 	verhandelt 	wurde , kam es Susanne Czapski seltsam vor . 
verhandeln_s35593_f1	Wer heute an den `` Nürnberger Prozeß '' denkt , ist sich der historischen Bedeutung dieser Abrechnung mit dem Dritten Reich bewußt - selbst wenn er gedanklich nur wenig von dem aufrufen kann , waskeywordtag kurz nach dem Ende des Zweiten Weltkriegs in jener Stadt 	verhandelt 	wurde , die den Nazis als Aufmarschgebiet für ihre monströsen Parteitage diente . 
verhandeln_s35979_f1	Über den wird nun 	verhandelt 	und es scheint Bewegung in die starren Fronten zu kommen . 
verhandeln_s36016_f1	Der Fall der Irakerin ist eine der fünf Verfassungsbeschwerden , über die am Dienstag und Mittwoch mündlich 	verhandelt 	wird . 
verhandeln_s36212_f1	Der Delegierte der deutschen Wirtschaft klagt , daß zum 31. März alle mit Staatsbetrieben geschlossenen Mietverträge `` neu 	verhandelt 	werden müssen '' . 
verhandeln_s36728_f1	Zuvor hatte die Gruppe erklärt , siekeywordtag 	verhandle 	mit einem nicht genannten Interessenten . 
verhandeln_s38045_f1	Derzeit werde mit mehreren Investoren 	verhandelt 	, hieß es . 
verhandeln_s39087_f1	Diesekeywordtag wollen enger zusammenrücken und 	verhandeln 	über ein `` integriertes Geschäftssystem '' , wie LH-Chef Jürgen Weber auf der Hauptversammlung sagte . 
verhandeln_s39642_f1		Verhandelt 	wird noch , welche Aktivitäten bei Textilfarbstoffen , die Hoechst mit Bayer zusammengelegt hatte , an Clariant übergehen . 
