versprechen_s1157_f1	Präsident General Ibrahim Babangida , der im August 1985 die Macht übernahm , hat 	versprochen 	, daß am 3. Januar 1993 ein gewählter Präsident seine Nachfolge antreten werde , die Wahl dafür soll im Dezember folgen . 
versprechen_s1704_f1	Konkret 	verspricht 	erkeywordtag meist nichtskeywordtag . 
versprechen_s1711_f1	Erkeywordtag werde sich den Willen der Bürger Hornos - wiekeywordtag vor Monaten schon 	versprochen 	- zur Leitlinie machen ; 
versprechen_s2005_f1	Der neue jugoslawische Ministerpräsident Milan Panic 	versprach 	den Demonstranten in einem Brief , sich für Rede- , Presse- und Versammlungsfreiheit einzusetzen und kündigte an , sich mit Oppositionsführer Vuk Draskovic zu treffen . 
versprechen_s2029_f1	Allerdings 	verspricht 	der Präsident seinem Wahlvolk seit Jahren ( bisher vergeblich ) , es aus dem Wachstumskeller herauszuführen , während der Kanzler das seine vor diesem Schicksal bewahren will . 
versprechen_s2041_f1	Von dem Besuch des russischen Präsidenten Boris Jelzin nach dem Gipfel in München 	verspricht 	sich die Siebener-Seilschaft allenfalls eine moralische Stärkung für ihren Gast aus Moskau . 
versprechen_s2101_f1	Die neue Regierung Rest-Jugoslawiens hat eine Beendigung der Kämpfe in Bosnien und Kroatien 	versprochen 	und die Konferenz für Sicherheit und Zusammenarbeit in Europa ( KSZE ) dringend ersucht , ihr dafür eine Frist von 100 Tagen einzuräumen . 
versprechen_s2629_f1	und die Wände der türkischen Polizeiwachen würden `` aus Glas '' sein , wiekeywordtag Ministerpräsident Süleyman Demirel im Wahlkampf 	versprochen 	hatte . 
versprechen_s2736_f1	`` Ich glaube nicht '' , sagt Ercan Kanar , `` daß die Folter unter dieser Regierung ausgemerzt wird , wie mankeywordtag unskeywordtag daskeywordtag 	verspricht 	. 
versprechen_s3051_f1	Staatschef Ibrahim Babangida hat die Übergabe der Macht an eine gewählte Zivilregierung bis Anfang 1993 	versprochen 	. 
versprechen_s3061_f1	Offenbar 	versprechen 	siekeywordtag sich davonkeywordtag mehr Vorteile für ihre eigenen Nuklearindustrien . 
versprechen_s5140_f1	Bundeskanzler Kohl 	verspricht 	vieleskeywordtag , hält jedoch wenig - aber , Kolleginnen und Kollegen - , und das ist das politisch Fatale - am Wahlverhalten ändert sich nichts ! 
versprechen_s5985_f1	Bei aussichtsreichen mittel- und langfristigen Vorhaben 	versprach 	Rexrodtkeywordtag nun eine Einzelfallprüfung . 
versprechen_s7825_f1	Spontan entschuldigte sich der Präsident bei seinen Landsleuten , daß die von ihm geführte Revolution `` noch nicht die erwünschten Früchte gebracht '' habe , und 	versprach 	, dies werde in seiner nächsten Amtszeit gewiß der Fall sein . 
versprechen_s7889_f1	Die Hormonpille 	verspricht 	Jugend , Gesundheit und Fitneß . 
versprechen_s8037_f1	Zuzutrauen wäre ihm daher , daß erkeywordtag dem SPD-Experten Börnsen den Chefposten der Regulierungsbehörde 	versprochen 	hat , wie in Bonn gemunkelt wird . 
versprechen_s8341_f1	Die Pille 	verspricht 	Jugend und Gesundheit . 
versprechen_s8372_f1	Ebenso wie Hussein sprach auch Ägyptens Hosni Mubarak , der erstmals Israel einen Besuch abstattete und dessen Worte nicht geplant waren , von einem `` wahren Helden des Friedens '' und 	versprach 	ebenso wie der Haschemitenherrscher , Yitzhak Rabin ein Denkmal zu setzen . 
versprechen_s8515_f1	Werde Israel `` den Weg des Friedens '' weitergehen , 	verspreche 	erkeywordtag : `` Amerikakeywordtag wirdkeywordtag euchkeywordtag nichtkeywordtag verlassenkeywordtag . '' 
versprechen_s9463_f1	Das Land Berlin werde der Einrichtung freilich `` besondere Aufmerksamkeit schenken '' , 	verspricht 	Fanselaukeywordtag . 
versprechen_s10048_f1	Wenn es nämlich nach seinen Träumereien ginge , wäre der Etat im nächsten Jahr nur mit einer Neuverschuldung von 22 Milliarden Mark belastet , wie erkeywordtag eskeywordtag vor erst drei Jahren in der Finanzplanung 	versprochen 	hatte . 
versprechen_s10414_f1	Die Frage ist nur : Leiden maßgebliche Vertreter der Arbeitgeber an Gedächtnisschwund - oder ist der Verband in so desolatem Zustand , daß nur noch der Griff zum Altbewährten das endgültige Fiasko abzuwenden 	verspricht 	? 
versprechen_s11446_f1	solche Menschen wenden ihre Ohren der verlockenden Stimme eines Populisten zu , derkeywordtag laut ausspricht , was sie denken , nämlich , daß sie betrogen wurden , und 	verspricht 	, alles wiedergutzumachen und mit seiner festen Hand das ersehnte Paradies auf Erden doch noch aufzubauen . 
versprechen_s11654_f1	Wirkeywordtag 	versprechen 	uns von diesem Jahr Abstinenz von StuPa und AStA eine Neufindung und Grunderneuerung . 
versprechen_s12673_f1	Ein Recht übrigens , das die UN schon mit der Stationierung der Blauhelme im Frühjahr 1992 zu garantieren 	versprochen 	hatten . 
versprechen_s12772_f1	Belgien , wie Luxemburg und Irland bisher ohne jeden Anspruch auf Elternurlaub , hat bereits eine entsprechende Unterstützung aus der Staatskasse 	versprochen 	. 
versprechen_s14257_f1	Eine von Eggar einberufene - erkeywordtag 	verspricht 	: unabhängigekeywordtag - internationale Gruppe von Umweltforschern und Ingenieuren soll nun über die `` umweltbeste '' Entsorgungsmöglichkeit für Brent Spar entscheiden . 
versprechen_s14261_f1	Trotzdem , 	verspricht 	Shell-Manager Heinz Rothermund , sollen die rund 200 seit `` Tag X '' am 20. Juni hereingekommenen Entsorgungsangebote unvoreingenommen geprüft werden . 
versprechen_s14871_f1	Für 1996 wird ein Überschuß auf dem Niveau von 1994 ( 64 Millionen ) 	versprochen 	. 
versprechen_s15283_f1	Das Stammwerk in Ludwigshafen behalte `` als einer der Knoten im Wertschöpfungsnetz '' sein besonderes Gewicht , 	verspricht 	Strubekeywordtag . 
versprechen_s15579_f1	Konzernen wie RWE , Veba , Viag , Thyssen , Mannesmann und ihren ausländischen Partnern öffnet sich ein Markt , derkeywordtag mittelfristig Milliardengewinnekeywordtag 	verspricht 	. 
versprechen_s17008_f1	Die Bergbahn-Betreiber 	versprechen 	seitdem eingefrorene Tarife . 
versprechen_s17010_f1	Einigekeywordtag 	versprechen 	sogar günstigere Pauschalangebote und Liftkarten-Abonnements für Familien . 
versprechen_s17267_f1	Die `` kurdische Sprache und Kultur pflegen '' sowie `` Kurden und Türken in einer Demokratie friedlich nebeneinander leben '' lassen - genau das also , waskeywordtag auch die türkische Regierungschefin Tansu Ciller den Kurden erst kürzlich wieder 	versprochen 	hat . 
versprechen_s17346_f1	Ich horchte in mich hinein und fragte mich , ob es mir wirklich Freude machen würde , umsorgt von den wilden Gesellen des Sindh zwischen den Riesentankern aus dem Iran und Japan Schalentiere zu essen , doch noch ehe ich mich entscheiden konnte , fand ich mich bereits als Tourist identifiziert und von einem halben Dutzend Bootseigentümer umgeben , diekeywordtag mirkeywordtag in einer stakkatoartigen Mischung aus Englisch und Urdu alle Herrlichkeiten dieser Bucht samt Speis und Trank 	versprachen 	, wenn ich nur bereit wäre , für die wunderbare Exkursion in guten Dollars zu zahlen . 
versprechen_s18269_f1	Der `` Superminister '' konnte nur durch die einmalige historische Konstellation zum Superstar werden , weil sich die Wirtschaftsbosse gute Geschäfte von Brandts `` Neuer Ostpolitik '' 	versprachen 	. 
versprechen_s18595_f1	Hundert Werke sind schon dem Ruf von `` Kettensägen-König '' Amazonino Mendes gefolgt , derkeywordtag Steuergeschenke und Billigkredite 	versprochen 	hat . 
versprechen_s19221_f1	Gerade die `` teilweise bösartige Polemik '' aus der SPD- und der Unionsfraktion veranlasse die FDP , `` nicht einen Millimeter zu wackeln in dieser Frage '' , 	verspricht 	Solmskeywordtag . 
versprechen_s19994_f1	Kleinkalibrigere Soziologie argumentiert gerne mit sehr begrenzten `` Fallstudien '' und 	verspricht 	deren Ausweitung auf später geplante profunde und flächendeckende Untersuchungen , die dann vielleicht aber doch nie kommen ; 
versprechen_s20567_f1	Die IG Metall 	verspricht 	in einer Grußadresse , den neuen Verband zu unterstützen . 
versprechen_s20578_f1	Im Wahlkampf habe der ehemalige Oppositionsführer 	versprochen 	, das rigide Arbeitsgesetz zu reformieren . 
versprechen_s21020_f1	Vom Zusammenlegen der Schauspielensembles und der technischen Abteilungen 	verspreche 	mankeywordtag sich , Kosten zu sparen und `` die Qualität zu steigern '' , sagte Scheydt . 
versprechen_s22393_f1	Viele bewegende Schauspiele sind hier früher durchlitten worden , in einer fernen Zeit , `` da die Götter menschlicher waren '' und die `` Menschen göttlicher '' , wiekeywordtag Karl Philipp Moritz , vielbelesener Menschenforscher und Romanautor , über die Antike seinerzeit zu wissen 	versprach 	. 
versprechen_s22402_f1	Statt dessen wird er nachts von seltsamen `` Gesichten '' besucht , einem `` Demon '' zum Beispiel , derkeywordtag ihmkeywordtag goldene Schätze 	verspricht 	und dafür eine gräßliche Bluttat fordert . 
versprechen_s23673_f1	Aber Michel Deflache vom Verband der Beaujolais-Winzer ( UIVB ) in Villefranche-sur-Saone 	verspricht 	: `` Der Beaujolais Nouveau 1995 ist fruchtig , abgerundet und körperreich . 
versprechen_s24223_f1	Von einem harten Kurs in der Kurdenpolitik 	verspricht 	sich Cillerkeywordtag vor allem Zulauf aus dem Lager der rechtskonservativen Wählerschaft . 
versprechen_s24236_f1	Von diesem Pakt 	verspricht 	siekeywordtag sich zusätzliche Mandate : 
versprechen_s24376_f1	Vor allem zwei Vorteile 	verspricht 	Coltkeywordtag den Unternehmen , die in England von British Telecom oder Mercury und in Deutschland von der Telekom weggelockt werden : 
versprechen_s24526_f1	Vielleicht ermutigt es jene , die ihre liebgewonnene D-Mark-Behausung bisher nur ungern gegen eine europäische Wohnung tauschen mögen , obgleich diesekeywordtag komfortabler zu werden 	verspricht 	: 
versprechen_s24571_f1	Auch Intel-Chef Andy Grove 	verspricht 	sich vielkeywordtag von der gemeinsamen Hard- und Software-Entwicklung . 
versprechen_s25615_f1	Seine Karte bleibt gültig , daskeywordtag 	verspricht 	ein Aushang in der Museumstür . 
versprechen_s25962_f1	Zudem hat Arzukeywordtag 	versprochen 	, gegen Steuerhinterziehung und Korruption vorzugehen . 
versprechen_s26262_f1	Hoch anzurechnen ist der Pariser Ausstellung , daß sie den zeitgenössischen Künstlerinnen den Raum gewährt , denkeywordtag der Titel 	verspricht 	, in dem ja das Weibliche bewußt vor das Männliche gesetzt wurde . 
versprechen_s26335_f1	Dort 	verspricht 	Montessorikeywordtag unter der Zwischenüberschrift `` Der Schlüssel zu allen Erziehungsproblemen '' nicht gerade wenig : 
versprechen_s26390_f1	Die Anzeige 	verspricht 	schnellen Erfolg : 
versprechen_s26406_f1	Künftigen Preßburger Medizin-Studenten werden ebenfalls leichtfertig Titelkeywordtag 	versprochen 	, gegen die Zahlung von rund 60 000 Dollar , wovon die Vermittler ein Viertel einstreichen . 
versprechen_s26412_f1	Mit anderen Worten : Die GWL kann eigentlich weder Studienplatz noch Titel 	versprechen 	. 
versprechen_s26987_f1	Im Namen des Parteivorstandes 	versprach 	erkeywordtag , daß alle Mitglieder der Parteiführung Konsequenzen ziehen würden . 
versprechen_s27306_f1	Einen erklecklichen Gewinn 	verspricht 	sich die Bank von einer gerade erworbenen 14-Prozent-Beteiligung an den Isarwerken , der Mutter des Stromkonzerns Isar-Amper . 
versprechen_s27899_f1	`` Das Einkaufserlebnis '' , von dem sich die Ifo-Forscher einen Konsumschub 	versprechen 	, stelle sich in diesem Stadtteil nicht her . 
versprechen_s29846_f1	Assekuranzkeywordtag 	verspricht 	Vorteilekeywordtag / 
versprechen_s29990_f1	Populistisch hatte Gingrichkeywordtag Anfang des Jahres , übrigens auch zur Überraschung der meisten Republikaner , 	versprochen 	, den US-Haushalt bis zum Jahre 2002 von Schulden freizumachen . 
versprechen_s33696_f1	Lafontainekeywordtag 	verspricht 	Neubeginnkeywordtag 
versprechen_s33718_f1	Erkeywordtag 	versprach 	den Menschen in Ostdeutschland überdies , sich vorrangig um ihre Sorgen kümmern zu wollen . 
versprechen_s33823_f1	`` So verhält man sich nicht gegenüber einer Schwesterkirche '' , sagt erkeywordtag und 	verspricht 	, wenn die Abwerbungsversuche aufhörten , auch den Papst treffen zu wollen . 
versprechen_s33957_f1	Im folgenden Jahr 	versprach 	das `` Weißbuch zu Wachstum , Wettbewerbsfähigkeit und Beschäftigung '' des damaligen EU-Kommissionspräsidenten Jacques Delors , die Arbeitslosigkeit um die Hälfte zu verringern . 
versprechen_s33970_f1	Spaniens Ministerpräsident Felipe González , Gastgeber des baldigen EU-Gipfels , 	versprach 	, sich dafür einzusetzen , beurteilte Erfolgschancen aber skeptisch . 
versprechen_s34185_f1	Lafontainekeywordtag 	verspricht 	Neubeginnkeywordtag 
versprechen_s34209_f1	Erkeywordtag 	versprach 	den Menschen in Ostdeutschland überdies , sich vorrangig um ihre Sorgen kümmern zu wollen . 
versprechen_s35622_f1	Chinakeywordtag 	verspricht 	umfassende Grenzöffnung / 
versprechen_s35637_f1	Erkeywordtag 	versprach 	außerdem , die Kooperation innerhalb der Apec mit umgerechnet 150 Millionen Mark zu fördern . 
versprechen_s35641_f1	Darin 	versprechen 	alle Teilnehmerstaaten , auf der wirtschaftlichen Ebene enger zusammenzuarbeiten . 
versprechen_s35767_f1	Justizministerkeywordtag 	verspricht 	Insassen von Korydallos verbesserte Bedingungen / 
versprechen_s35926_f1	Obwohl sich der alte und der neue Vorsitzende loyale Zusammenarbeit 	versprochen 	haben , gibt es aber auch Fraktionsmitglieder , die anhaltende Konflikte vorhersagen . 
versprechen_s36194_f1	Erkeywordtag könne ihnenkeywordtag eine Lizenz innerhalb von 15 Tagen 	versprechen 	, wenn sie ihr Unternehmen in zwei der noch freien Industriezonen der Stadt ansiedeln . 
versprechen_s36213_f1	Ähnliche Hürden ertragen ausländische Investoren in China ohne großes Murren , dessen Milliardenbevölkerung einen riesigen Inlandsmarkt 	verspricht 	. 
versprechen_s36844_f1	`` Wir machen alles , was aus Glas zu machen ist '' , 	verspricht 	Schelerkeywordtag . 
versprechen_s36873_f1	Offenbar darüber , daß die angebotenen Schiffsbeteiligungen `` maximale Steuervorteile '' 	versprechen 	. 
versprechen_s38097_f1	Siekeywordtag 	verspricht 	sich davonkeywordtag Einsparungen in `` zweistelliger Millionenhöhe '' . 
versprechen_s38483_f1	Von einer entsprechenden Reform 	verspricht 	sich der Manager auch positive Auswirkungen auf das `` Anforderungsprofil '' der Aufseher . 
versprechen_s38625_f1	Harte Arbeit 	verspricht 	Driesekeywordtag auch , um sich der Vison einer Beraterbank anzunähern und den Service für die Sparda-Banken noch zu verbessern . 
versprechen_s39331_f1	France Télécom 	verspricht 	den Kunden bis 2000 erhebliche Tarifsenkungen . 
versprechen_s39432_f1	Noch vor wenigen Jahren hatte das Forschungsministerium 	versprochen 	, den Raumfahrt-Haushalt auf 2,2 Milliarden Mark per annum anzuheben . 
versprechen_s39639_f1	Besondere Wachstumschancen 	versprechen 	sich die Eidgenossen in erweiterter Formation von Nord- und Lateinamerika sowie Fernost . 
versprechen_s39789_f1	Immer neue restriktive Gesetze haben die `` Unions '' außerdem in enge Grenzen verwiesen - Grenzen , die auch die Labour Party beizubehalten gelobt , wiewohl Tony Blair dem gewerkschaftlichen Betätigungsfeld , erstmals in der britischen Geschichte , eine gesetzliche Grundlage zu geben 	verspricht 	. 
versprechen_s39808_f1	Inzwischen 	verspricht 	die Partei im Falle eines Wahlsieges am 1. Mai sogar `` eigene Privatisierungs-Initiativen '' - wie zum Beispiel Verkauf der Flugsicherung an zahlungskräftige Interessenten . 
versprechen_s39864_f1	Darüber hinaus 	verspricht 	sich die Politikerin von der Reform einen heilsamen Druck , künftig kostengünstiger zu bauen . 
versprechen_s40009_f1	Wäsche sei die letzte Bastion im Bekleidungsgeschäft , diekeywordtag noch eine explosionsartige Entwicklung 	verspreche 	, hofft Haller . 
