versichern_s82_f0	Auch wenn Manmohan Singh immer wieder 	versichert 	, er rechne nach der Öffnung der indischen Wirtschaft mit ausländischen Investitionen von bis zu sechs Milliarden Dollar im Laufe der nächsten drei Jahre , so sind bis Ende März nicht mehr als 480 Millionen ins Land geflossen . 
versichern_s2400_f0	Waffenschmidtkeywordtag 	versicherte 	, daß der russische Regierungschef , Jegor Gaidar , einer Unterzeichnung am heutigen Montag bereits vergangene Woche zugestimmt habe . 
versichern_s2934_f0	Minister Delcroix 	versichert 	, mit einer bedeutend kleineren , aber modern und gut ausgerüsteten Armee werde Belgien in Zukunft seine internationalen Verpflichtungen auch im Rahmen der NATO erfüllen . 
versichern_s2978_f0	Bis zu seinem altersbedingten Abschied vom Chefsessel des größten deutschen Elektrokonzerns am 1. Oktober jedenfalls `` habe ich noch genug zu tun '' , 	versichert 	der 64jährige Manager . 
versichern_s5803_f0	`` Diese Platte war Freddies letzter Wille , danach wird es Queen nicht mehr geben '' , 	versichert 	Brian May , `` Freddie wollte damals , daß wir jedesmal ins Studio gingen , wenn er sich einigermaßen gut fühlte . 
versichern_s6549_f0	Angehörige der Schweizer Botschaft hatten bereits vergangene Woche 	versichert 	, die Schweiz werde in dieser Bestechungsaffäre das Bankgeheimnis voraussichtlich aufheben . 
versichern_s7606_f0	Die Chinesen könnten den Eindruck gewinnen , daß die Deutschen es nun `` ungeheuer ernst meinen '' , 	versichert 	ein Diplomat . 
versichern_s8528_f0	Pereskeywordtag 	versicherte 	einem französischen Regierungsbeamten zufolge nach einem Gespräch mit seinem französischen Amtskollegen Jacques Chirac , daß an dem für die Wahlen der Palästinenser vorgesehenen Termin , dem 20. Januar nächsten Jahres , festgehalten werde . 
versichern_s9741_f0	Obwohl Premierminister Wim Kok in den vergangenen Wochen mehrmals 	versicherte 	, daß sein Kabinett Fokker `` nicht den Rücken zudrehen '' werde , haben sich bisher lediglich die oppositionellen Christdemokraten im Parlament für eine vorbehaltlose Unterstützung ausgesprochen . 
versichern_s10242_f0	Töpferkeywordtag 	versicherte 	, die Bundesregierung bekenne sich trotz Kritik der Arbeitgeber zum Gesetzentwurf . 
versichern_s13048_f0	Natürlich halte er von der Gesetzesänderung eigentlich nichts , 	versicherte 	etwa der mittelstandspolitische Sprecher der Union , Hansjürgen Doss . 
versichern_s13094_f0	Natürlich halte er von der angepeilten Gesetzesänderung eigentlich nichts , 	versicherte 	etwa der mittelstandspolitische Sprecher der Union , Hansjürgen Doss . 
versichern_s13309_f0	`` Aber die Deutschen werden immer liberaler , in fünf Jahren ist da alles wie hier '' , 	versichert 	Theokeywordtag . 
versichern_s14040_f0	Eine rechthaberische Streitlust bis hin zum gewalttätigen machismo sagte man ihm nach , derkeywordtag stets zu 	versichern 	bereit war , daß es in Mexiko keinen einzigen Homosexuellen gebe . 
versichern_s17028_f0	Ein Skifahrer , so 	versichert 	Tognikeywordtag , wolle immer auf die Piste . 
versichern_s17037_f0	So 	versicherte 	zwar jüngst TUI-Vorstand Marc Pasture , die Bedeutung des Winterurlaubs werde für den Großveranstalter immer wichtiger , stellte dabei aber gleichzeitig fest : `` Wesentlich haben dazu die Badeziele beigetragen . '' 
versichern_s17060_f0	`` Die Skigebiete in Tschechien und in der Slowakei haben einen wahnsinnigen Zulauf '' , 	versicherte 	NUR-Direktor Degenhardt . 
versichern_s18883_f0	`` Der Stabilitätspakt für Europa ist ein wichtiger zusätzlicher Impuls für die Glaubwürdigkeit und Stabilität der europäischen Währung auf den internationalen Finanzmärkten '' , 	versicherte 	Waigelkeywordtag . 
versichern_s19008_f0	Privatkunden , so wird 	versichert 	, seien wie schon in der Vergangenheit von den Machenschaften nicht betroffen . 
versichern_s19121_f0	Er habe nicht einmal jemandem nahelegen müssen , selbst zu gehen , 	versicherte 	Kirchenamtschef Otto von Campenhausen auch bedauernd : 
versichern_s19226_f0	`` Von bitte , bitte war da keine Rede '' , 	versichert 	ein Vertrauter des FDP-Chefs . 
versichern_s19465_f0	Bei einem Besuch im ehemaligen Vernichtungslager Auschwitz hat UN-Generalsekretär Butros Butros-Ghali 	versichert 	, auch die Vereinten Nationen würden alles dazu tun , daß sich der Holocaust nie wiederhole . 
versichern_s20753_f0	Der Verkauf der beiden Unternehmen bringe Bonn mit Sicherheit vier Milliarden Mark ein , 	versicherte 	Waigelkeywordtag im Haushaltsausschuß . 
versichern_s21559_f1	Dieser hat aber nach Ansicht politischer Beobachter im zweiten Wahlgang durchaus gute Chancen , für weitere fünf Jahre Präsident zu bleiben , da ihmkeywordtag die Freiheitsunion als größte Oppositionspartei ihre Unterstützung 	versichert 	hat . 
versichern_s21718_f0	Mit der Plakataktion solle `` niemand an den Pranger gestellt werden '' , wird amtlicherseitskeywordtag 	versichert 	. 
versichern_s22915_f0	Innenminister Franz-Josef Kniola ( SPD ) 	versicherte 	am Montag , daß die Regierung `` grundsätzlich '' an der Reise festhalte . 
versichern_s25046_f0	Hier geht es um den `` sicherheitspolitischen Dialog '' , wiekeywordtag Helmut Kohl später am selben Tag auf einer internationalen Pressekonferenz 	versichert 	. 
versichern_s25538_f0	Parkerkeywordtag 	versicherte 	, sein Film über Szenen aus dem Leben der 1952 gestorbenen zweiten Frau von Ex-Präsident Juan Domingo Peron werde `` weder pro-peronistisch , noch anti-peronistisch '' sein . 
versichern_s25641_f0	In einem Brief an den republikanischen Präsidenten des Repräsentantenhauses , Newt Gingrich , 	versicherte 	Clintonkeywordtag in Washington , daß der Einsatz eine Ausweitung des Krieges auf dem Balkan verhindern und US-Führungskraft demonstrieren würde . 
versichern_s25980_f0	Nachdem Ministerpräsident Li Peng am Vorabend überraschend und in letzter Minute seine Teilnahme an einem Empfang des Kanzlers in Peking abgesagt hatte , wurde 	versichert 	, der Premier werde aber wie geplant nach Qingdao kommen . 
versichern_s28023_f0	Pereskeywordtag 	versicherte 	, er werde am Frieden mit den arabischen Nachbarn und der Versöhnung unter den Israelis arbeiten . 
versichern_s29579_f0	Walesakeywordtag hatte stets 	versichert 	, er habe das Geld aus den Filmrechten korrekt versteuert und zu einem Großteil gespendet . 
versichern_s29845_f1	Eurogeldkeywordtag bleibt gut 	versichert 	
versichern_s33605_f0	Mitarbeiter des Stadtmagazins Die Wage fanden aber zahlreiche Zeugen , diekeywordtag übereinstimmend 	versicherten 	, die Feuerwehr schon mindestens eine halbe Stunde vorher alarmiert zu haben . 
