verurteilen_s370_f0	Zehn von dreihundert verhafteten Demonstranten wurden in Schnellverfahren zur Todesstrafe 	verurteilt 	, vier von ihnen unmittelbar darauf hingerichtet . 
verurteilen_s1267_f0	Ein Gericht in der mexikanischen Stadt Guadalajara hat drei Polizeioffiziere wegen der Beteiligung an der Entführung des mexikanischen Arztes Humberto Alvarez Machain zu Haftstrafen von jeweils 18 Jahren und neun Monaten 	verurteilt 	. 
verurteilen_s1430_f0	Siekeywordtag waren wegen eines geplanten Angriffes auf israelische Einrichtungen zu zweieinhalb Jahren Haft 	verurteilt 	worden . 
verurteilen_s2552_f0	Auch würden die Verantwortlichen für den Bürgerkrieg eindeutig 	verurteilt 	und weitere Hilfsmaßnahmen für die Bevölkerung in Aussicht gestellt . 
verurteilen_s2884_f0	Da gab es den führenden PKK-Funktionär Ali Cetiner , der , nachdem erkeywordtag in Berlin wegen Mordes lediglich zu fünf Jahren Haft 	verurteilt 	worden war , beim Düsseldorfer Kurdenprozeß einen derart schwachen Auftritt hinlegte , daß selbst die Bundesanwaltschaft ins Zweifeln geriet . 
verurteilen_s2903_f0	In Sarajewo wurde dieser Akt als `` gesetzwidrig '' und `` unrechtmäßig '' 	verurteilt 	. 
verurteilen_s3646_f0	Irakkeywordtag bestritt die Vorwürfe und 	verurteilte 	die UN-Bewachung des Gebäudes als Eingriff in seine Souveränität . 
verurteilen_s3913_f0	Der Herausgeber der algerischen Wochenzeitung `` Ech Chourouk el Arabi '' sowie ein leitender Journalist des Blattes , Ali Fodhil und Saad Bouakba , sind am Montag zu je vier Monaten Gefängnis 	verurteilt 	worden . 
verurteilen_s3914_f0	Wie der algerische Rundfunk meldete , wurden die beiden Journalisten wegen `` Anstiftung zu Vergehen gegen die staatliche Sicherheit '' , `` Angriffen auf die Interessen der Nation '' sowie `` Beleidigung der Staatsgewalt '' 	verurteilt 	. 
verurteilen_s4279_f0	Während Ägypten , Jordanien und die PLO-Führung das Attentat 	verurteilten 	, kamen aus Iran , Libyen und Syrien Kommentare mit unverhohlener Sympathie für die Bluttat . 
verurteilen_s4389_f0	Der Berliner Politologe und Sprecher des Komitees für Grundrechte und Demokratie ist vom Bonner Amtsgericht wegen des Aufrufs zu Straftaten zu einer Geldstrafe von 5400 Mark 	verurteilt 	worden . 
verurteilen_s4551_f0	Siekeywordtag sollte 	verurteilt 	, klug getilgt und isoliert werden . 
verurteilen_s5125_f0	Der Angeklagte wurde 	verurteilt 	. 
verurteilen_s5129_f0	Ein dritter Angeklagter war 	verurteilt 	worden , weil er in einem Leserbrief das Tucholsky-Zitat ausdrücklich befürwortete und wiederholte : `` Alle Soldaten sind potentielle Mörder '' . 
verurteilen_s5131_f0	Auch sie wurde wegen Beleidigung der an dem Stand anwesenden Soldaten 	verurteilt 	. 
verurteilen_s5765_f0	Natürlich ist auch die Opposition entsetzt und 	verurteilt 	die `` Wahnsinnstat '' . 
verurteilen_s6037_f0	Im Juni 1967 , als es in der deutschen Bundesrepublik vorübergehend gärte , wurde der politisch wache Isang Yun zusammen mit siebzehn Leidensgenossen vom südkoreanischen Geheimdienst als Verschlußsache außer Landes befördert , im Schauprozeß zum Tode 	verurteilt 	, nach Interventionen zu erst 15 , dann zehn Jahren `` begnadigt '' , und dann - gebrochen an Seele und Körper , nicht aber am Geiste - wieder `` auf freien Fuß '' gesetzt . 
verurteilen_s6429_f0	Sieben PKK-Mitglieder zum Tode 	verurteilt 	
verurteilen_s6431_f0	Das Staatssicherheitsgericht in der westtürkischen Hafenstadt Izmir hat am Montag sieben Mitglieder der kurdischen Separatistenorganisation PKK wegen Terrorismus zum Tode 	verurteilt 	. 
verurteilen_s6463_f0	Betreiber von `` Nationalem Telefon '' 	verurteilt 	
verurteilen_s6465_f0	Wegen Volksverhetzung und Telefonterrors ist ein 22jähriger Mainzer von der 3. Strafkammer des Landgerichts am Montag zu zwölf Monaten Jugendstrafe auf Bewährung 	verurteilt 	worden . 
verurteilen_s6634_f0	Drei von ihnen waren im selben Verfahren freigesprochen worden , ein anderer mit drei weiteren zu Haftstrafen 	verurteilt 	worden . 
verurteilen_s8386_f0	Syriens Präsident Hafiz al-Assad hatte in einem Telefongespräch mit US-Außenminister Warren Christopher die Ermordung Rabins `` in unmißverständlicher Schärfe 	verurteilt 	'' . 
verurteilen_s8519_f0	Schaath vertrat bei der Trauerfeier PLO-Chef Yassir Arafat , derkeywordtag den Anschlag auf Rabin 	verurteilt 	hatte , an dem Staatsakt jedoch aus Sicherheitsgründen nicht teilnahm . 
verurteilen_s8524_f0	Aus US-Regierungskreisen verlautete dagegen , der syrische Präsident Hafes el Assad habe den Mord 	verurteilt 	. 
verurteilen_s8548_f0	Ein korrupter Richter in Brasilien hat nach Angaben eines hohen venezolanischen Beamten die Freilassung von drei brasilianischen Goldsuchern angeordnet , diekeywordtag wegen Mordes an mindestens 17 Indios zu lebenslanger Haft 	verurteilt 	worden waren . 
verurteilen_s8643_f0	Das Gericht 	verurteilte 	im Gegensatz zum Landesarbeitsgericht das Land Sachsen-Anhalt , einen Hochschulprofessor mit Lehrauftrag für Informationsverarbeitung weiterzubeschäftigen . 
verurteilen_s8751_f0	Die Judenverfolgung hat erkeywordtag aber nie öffentlich 	verurteilt 	. 
verurteilen_s8838_f0	Der entschiedene Pazifist ist gerade unter anderem wegen `` Landesverrats '' zu 18 Monaten Haft 	verurteilt 	worden . 
verurteilen_s9163_f0	Ein britisches Berufungsgericht hat am Dienstag vier Geschäftsleute freigesprochen , diekeywordtag wegen Waffenhandels mit Irak in der Zeit vor dem Golf-Krieg 	verurteilt 	worden waren . 
verurteilen_s9166_f3	Ohne die Papiere hatte vor drei Jahren ein Gericht drei der vier Geschäftsleute zu Bewährungsstrafen und einen von ihnen zu einer Geldstrafe 	verurteilt 	. 
verurteilen_s9187_f0	Die rechtsextremen Mörder wurden erst lange Jahre nach dem Anschlag ermittelt und verurteilt , denn die Polizei verfolgte zunächst eine ganz andere Spur - eine einzige . 
verurteilen_s9846_f0	Aufgrund von Strafanzeigen einzelner Soldaten und des Bundesverteidigungsministeriums waren siekeywordtag wegen Beleidigung zu Geldstrafen 	verurteilt 	worden . 
verurteilen_s10193_f0	Ob Verwender des Tucholsky-Zitats 	verurteilt 	werden oder nicht , wird zur Gretchenfrage . 
verurteilen_s11039_f0	Die Fluggesellschaft British Airways ist zu Schadenersatz in Millionenhöhe 	verurteilt 	worden , weil eine ihrer Maschinen im August 1990 nach dem Einmarsch irakischer Truppen in Kuwait gelandet war . 
verurteilen_s11233_f0	Er sagte in der Nacht zum Mittwoch im US-Fernsehsender CNN , er selbst habe Gewalt als Mittel , sich in die Politik Israels einzumischen , stets 	verurteilt 	. 
verurteilen_s11564_f0	Aber auch den Ex-Verteidigungsminister , Hector Gramajo , derkeywordtag von einem US-Gericht wegen Menschenrechtsverletzungen zur Zahlung von 47,5 Millionen Dollar 	verurteilt 	wurde . 
verurteilen_s11951_f0	Im sogenannten Stiefelmord-Prozeß hat das Landgericht Göttingen am Mittwoch die Angeklagten zu sieben Jahren Haft beziehungsweise sechs Jahren Jugendstrafe 	verurteilt 	. 
verurteilen_s11999_f0	1956 wurde der zwei Jahre zuvor nach Ostberlin entführte und im Dezember 1955 mit Hilfe des mit ihm befreundeten dänischen Journalisten Bonde-Henriksen zurückgekehrte ehemalige Präsident des BRD-Verfassungsschutzes , ein Mann des 20. Juli , von Nazi-Juristen als `` Verräter '' 	verurteilt 	. 
verurteilen_s12368_f0	Der ehemalige Vorsitzende der verbotenen Nationalistischen Front ( NF ) , Meinolf Schönborn , wurde am Mittwoch zu zwei Jahren und drei Monaten Haft 	verurteilt 	. 
verurteilen_s12371_f0	Die Mitangeklagten , frühere Führungsmitglieder der NF , wurden zu je zehn Monaten Haft 	verurteilt 	. 
verurteilen_s13569_f0	In China sind am Mittwoch vier Elfenbeinschmuggler vor einer Versammlung von 10 000 Menschen zum Tode 	verurteilt 	worden . 
verurteilen_s13586_f0	Bundesaußenminister Klaus Kinkel ( FDP ) 	verurteilte 	die Bestätigung der Todesurteile `` aufs schärfste '' . 
verurteilen_s14114_f1	Mouralikeywordtag wurde im Mai wegen `` Mitgliedschaft von En Nahda '' zu drei Jahren und Ben Gharbia wegen Teilnahme an einer Kundgebung in Deutschland gegen Tunesiens Regierung zu 14 Monaten Gefängniskeywordtag 	verurteilt 	. 
verurteilen_s14353_f0	Die Führer vieler Commonwealth-Nationen haben sich bereits im Vorfeld des Treffens darauf geeinigt , Major auf der Konferenz zu isolieren und Großbritannienkeywordtag wegen seiner frankreichfreundlichen Position scharf zu verurteilen . 
verurteilen_s14424_f0	Dieser Umstand mußte zu der Überlegung Anlaß geben , ob sich die Äußerung nicht gegen Soldatentum und Kriegshandwerk schlechthin richtete , daskeywordtag 	verurteilt 	wird , weil es mit dem Töten anderer Menschen verbunden ist , das unter Umständen auf grausame Weise vor sich geht und auch die Zivilbevölkerung trifft . 
verurteilen_s14689_f0	Wegen Volksverhetzung ist Günter Deckert seit Ende Oktober rechtskräftig 	verurteilt 	. 
verurteilen_s15072_f0	Wegen der Auschwitzleugnung ist Deckertkeywordtag bereits in einem früheren Verfahren zu einer zweijährigen Haftstrafe ohne Bewährung 	verurteilt 	worden . 
verurteilen_s15384_f0	Wegen dieses Engagements war der populäre TV-Autor und Schriftsteller von der Junta in einem alle juristischen Regeln verletzenden Schauprozeß zusammen mit acht Mitangeklagten für den Mord an vier Ogoni-Führern zum Tode 	verurteilt 	worden ( siehe auch FR- Feuilleton v. 4. 11. ) . 
verurteilen_s15541_f0	1947 war Küblerkeywordtag von einem jugoslawischen Militärgericht zum Tode 	verurteilt 	und hingerichtet worden . 
verurteilen_s15899_f0	Die Türkei 	verurteilte 	die Preisverleihung heftig . 
verurteilen_s16099_f0	Einstige Kolonialstaaten 	verurteilen 	Frankreichs Atomtests / 
verurteilen_s16107_f0	In dem schließlich verabschiedeten Aufruf hieß es wörtlich : `` Die überwältigende Mehrheit der Staats- und Regierungschefs des Commonwealth 	verurteilt 	die anhaltenden Atomversuche . '' 
verurteilen_s16185_f0	US-Wissenschaftlerkeywordtag wegen Spionage 	verurteilt 	
verurteilen_s16187_f0	Der US-amerikanische Sozialwissenschaftler Jeffrey Schevitz ist am Freitag vom Oberlandesgericht Stuttgart wegen Spionage für die DDR zu einer 18monatigen Bewährungssstrafe 	verurteilt 	worden . 
verurteilen_s16245_f0	Der 33jährige Albert war wegen Mordes zu lebenslanger Haft 	verurteilt 	. 
verurteilen_s17257_f0	Nach Auskunft der Bundestagsabgeordneten Angelika Beer ( Bündnisgrüne ) war erkeywordtag zuvor in drei von 43 Anklagepunkten wegen `` Separatismuspropaganda '' zu 58 Monaten Haft 	verurteilt 	worden . 
verurteilen_s18374_f0	Bousquetkeywordtag wurde nach dem Krieg zu einer milden Strafe 	verurteilt 	, war aber schon bald Chef der Banque d'Indochine und Freund François Mitterrands . 
verurteilen_s18381_f0	Der Mordprozeß begann am 6. November , und Didierkeywordtag wird ohne Zweifel als Mörder 	verurteilt 	werden , wahrscheinlich mit dem Psycho-Rabatt mildernder Umstände . 
verurteilen_s18771_f0	Siekeywordtag wurde gemeinsam mit fünf anderen Kurdenpolitikern wegen angeblicher Kontakte zur militanten kurdischen Arbeiterpartei PKK angeklagt und vom Staatssicherheitsgericht in Ankara zu 15 Jahren Haft 	verurteilt 	. 
verurteilen_s18918_f0	Siekeywordtag wurde gemeinsam mit fünf anderen Kurdenpolitikern wegen angeblicher Kontakte zur militanten kurdischen Arbeiterpartei PKK angeklagt und im Dezember 1994 vom Staatssicherheitsgericht in Ankara zu 15 Jahren Haft 	verurteilt 	. 
verurteilen_s20711_f0	Zudem könne es nicht angehen , daß die Schützen 	verurteilt 	würden , die Befehlshaber jedoch ungeschoren davonkämen . 
verurteilen_s20922_f0	Die in Neusseland versammelten Commonwealth-Politiker hatten die Hinrichtungen vom Freitag scharf 	verurteilt 	und als `` Justizmord '' bezeichnet . 
verurteilen_s21408_f0	Gleichwohl würden die meisten Festgenommenen nicht 	verurteilt 	. 
verurteilen_s22126_f0	Erkeywordtag beansprucht kein nationales Gebiet und 	verurteilt 	nicht . 
verurteilen_s22867_f0	Zahlreiche arabische Staaten 	verurteilten 	den jüngsten Anschlag . 
verurteilen_s23326_f0	Das saudische Kabinett unter König Fahd 	verurteilte 	den Anschlag als eine `` Tat , die unserer Gesellschaft , unseren Wertvorstellungen und unserer Religion fremd ist '' . 
verurteilen_s23367_f0	Die amerikanische UN-Botschafterin Madeleine Albright erörterte am Montag in New York mit führenden Mitgliedern der beiden Gremien , die nigerianische Militärregierung in einer Resolution zu verurteilen und UN-Sanktionen einzuführen . 
verurteilen_s23448_f0		Verurteilt 	wegen Mord an Deutscher 
verurteilen_s23460_f0	Aufgrund seiner Jugend wurde erkeywordtag nicht zum Tode 	verurteilt 	. 
verurteilen_s23630_f0	Der Präsident der HRK , Hans-Uwe Erichsen , 	verurteilte 	die Kritik der Politik an den Überlegungen seiner Organisation . 
verurteilen_s23788_f0	Die UN erwägen , die Vollstreckung der Todesurteile in einer Resolution zu verurteilen und ein Waffenembargo gegen Nigeria zu beschließen . 
verurteilen_s23789_f0	Nach Einschätzung von Beobachtern ist die Verhängung von Sanktionen gegen das Militärregime jedoch unwahrscheinlich , da Rußland und China meist ihr Veto gegen Resolutionen einlegen , diekeywordtag `` innere Angelegenheiten '' eines Landes 	verurteilen 	. 
verurteilen_s23881_f0	Erkeywordtag war 1994 vom Landgericht Berlin wegen Rechtsbeugung , zweifachen Totschlags und versuchten Totschlags zu drei Jahren und neun Monaten Haft 	verurteilt 	worden . 
verurteilen_s24780_f0	Mörder Bousquets 	verurteilt 	
verurteilen_s24782_f0	Im Prozeß um die Ermordung des mit Hitler-Deutschland zusammenarbeitenden Polizeichefs des französischen Vichy-Regimes , René Bousquet , ist der Angeklagte Christian Didier zu zehn Jahren Haft 	verurteilt 	worden . 
verurteilen_s24840_f0	Wegen seines Alters wurde erkeywordtag aber nicht zum Tode 	verurteilt 	. 
verurteilen_s25176_f0	Der Verein der Tibeter in Deutschland ( VTD ) 	verurteilte 	den Besuch Kohls beim chinesischen Militär . 
verurteilen_s25246_f0	Der iranische Präsident Haschemi Rafsandschani habe Terrorimuskeywordtag nie gutgeheißen , sondern stets uneingeschänkt 	verurteilt 	. 
verurteilen_s25255_f0	Scharf 	verurteilte 	Scharpingkeywordtag `` Profilsucht und Egoismus '' im Parteivorstand . 
verurteilen_s25392_f0	Scharf 	verurteilte 	SPD-Chef Scharping Profilsucht und Egoismus im Parteivorstand . 
verurteilen_s25701_f0	Richterkeywordtag 	verurteilt 	Ehemannkeywordtag zum Blumenschenken 
verurteilen_s25703_f0	Ein israelischer Richter hat einen Mann in Beersheva dazu 	verurteilt 	, seiner Ehefrau einen Monat lang täglich Blumen zu schenken . 
verurteilen_s25763_f0	Die 2000 Delegierten der Unesco-Generalversammlung 	verurteilten 	am Dienstag die Hinrichtung Ken Saro-Wiwas und der anderen acht Ogoni . 
verurteilen_s25784_f0	Anführer der Meuterer sei der Anarchist Giorgos Balafas , derkeywordtag vor einer Woche zu zehn Jahren Gefängnis 	verurteilt 	wurde . 
verurteilen_s27412_f0	Ein Schöffengericht 	verurteilte 	den 36jährigen am Montag wegen Nötigung in einem besonders schweren Fall zu einer Freiheitsstrafe von einem Jahr auf Bewährung . 
verurteilen_s27481_f0	Der frühere Vorsitzende Richter des Bezirksgerichts Dresden , Klaus Helmut Braune , war 1994 wegen zwei Fällen der Rechtsbeugung vom Landgericht Dresden zu eineinhalb Jahren Freiheitsstrafe mit Bewährung 	verurteilt 	worden . 
verurteilen_s27488_f0	Braunekeywordtag sei in zwei Fällen zu Recht wegen Rechtsbeugung 	verurteilt 	worden . 
verurteilen_s27489_f0	Erkeywordtag habe einen Arzt und einen Familienvater wegen `` staatsfeindlicher Hetze '' zu sechzehn Monaten und sechs Jahren Freiheitsstrafe 	verurteilt 	und damit gegen Gerechtigkeitsgrundsätze verstoßen . 
verurteilen_s27492_f0	Siekeywordtag waren deshalb unter dem Vorsitzenden Braune wegen Agententätigkeit und landesverräterischer Nachrichtenübermittlung zu Haftstrafen zwischen fünfzehn Monaten und vier Jahren 	verurteilt 	worden . 
verurteilen_s27493_f0	Im vierten Fall war die Mutter eines politischen Häftlings , eine Rentnerin , vom Angeklagten zu drei Jahren und drei Monaten 	verurteilt 	worden , weil sie einen Kassiber ihres Sohnes aus dem Gefängnis geschmuggelt und weitergeleitet hatte . 
verurteilen_s28217_f0	Wegen Mordes an dem deutschen Touristen Uwe-Wilhelm Rakebrand ist eine 22jährige in Miami ( US-Bundesstaat Florida ) zu 25 Jahren Gefängnis 	verurteilt 	worden . 
verurteilen_s28328_f0	Das Gericht hatte den Rechtsextremisten wegen gefährlicher Körperverletzung und Nötigung 	verurteilt 	, weil er 1994 bei einer Schülerfeier in Sudheim ( Kreis Northeim ) mit Schüssen aus einer Gaspistole Schüler verletzt hatte . 
verurteilen_s28453_f0	Ein kroatisches Militärgericht soll elf Serben wegen Aufruhrs zu mehrjährigen Haftstrafen 	verurteilt 	haben . 
verurteilen_s28471_f0	Ex-Ministerkeywordtag wegen Bestechlichkeit 	verurteilt 	
verurteilen_s28473_f0	In Frankreich ist der frühere Kommunikationsminister Alain Carignon zu fünf Jahren Haft 	verurteilt 	worden , davon zwei Jahre auf Bewährung . 
verurteilen_s30010_f0	Während sein Stabschef Leon Panetta im Kongreß mit den Führern der Republikaner über einen Kompromiß verhandelte , 	verurteilte 	der Präsident im Stile des besorgten Landesvaters die Republikaner bei einer Pressekonferenz als Leute , die `` Ideologie über den gesunden Menschenverstand und die von allen geteilten Werte setzen '' . 
verurteilen_s30090_f0	Zweimal haben Strafsenate des Bundesgerichtshofs in dieser Woche ehemalige DDR-Richter rechtskräftig wegen Rechtsbeugung 	verurteilt 	. 
verurteilen_s30106_f0	Der ehemalige DDR-Jurist ist unter anderem wegen dieses Falles in dieser Woche vom BGH rechtskräftig wegen Rechtsbeugung 	verurteilt 	worden . 
verurteilen_s30113_f0	Sein Beisitzer in diesem Verfahren , Hans-Joachim Rehse , wurde wegen Rechtsbeugung angeklagt und auch wegen dieses Falles zunächst 	verurteilt 	. 
verurteilen_s30586_f0	Er bestätigte das Urteil des Berliner Landgerichts , daskeywordtag 1994 den Richter am Obersten Gericht der DDR Hans Reinwarth zu einer Haftstrafe von drei Jahren und neun Monaten 	verurteilt 	hatte . 
verurteilen_s30974_f0	Zu lebenslangen Freiheitsstrafen wurden zwei junge US-Amerikaner in Miami wegen des Mordes an dem deutschen Touristen Uwe-Wilhelm Rakebrand 	verurteilt 	. 
verurteilen_s31354_f0	Ex-GSG-9-Beamterkeywordtag wegen Mißhandlung 	verurteilt 	
verurteilen_s31357_f0	Das Gericht hob am Freitag einen Freispruch der ersten Instanz auf und 	verurteilte 	den Ex-Beamten der GSG-9-Sondereinheit zu einer Geldstrafe von 4800 Mark , die zur Bewährung ausgesetzt wurde . 
