verweigern_s470_f1	Wie im Fall einiger Mitglieder der Künstlervereinigung UNEAC , die vor einem Jahr ähnliche Reformen anregten , 	verweigert 	die Regierung von Präsident Fidel Castro Andersdenkendenkeywordtag jede Möglichkeit des Dialogs . 
verweigern_s1787_f1	Er sei erstaunt , sagte Khor , daß dem Gegenkongreß die Räumlichkeiten in der Münchner Universität 	verweigert 	worden waren . 
verweigern_s1954_f1	Rund 2000 Menschen aus dem zerfallenen Vielvölkerstaat ist seit Donnerstag nacht vorwiegend an der ungarischen Bahngrenzstation Hegyeshalom die Einreise nach Österreich 	verweigert 	worden . 
verweigern_s1955_f1	Den Charme , mit dem österreichische Grenzbeamte am Straßenübergang Nickelsdorf ahnungslosen Autofahrern die Einreise 	verweigerten 	, schilderte die konservative `` Die Presse '' so : 
verweigern_s1981_f1	Khor zeigte sich erstaunt darüber , daß dem Gegenkongreß die Räumlichkeiten in der Münchner Universität 	verweigert 	worden waren . 
verweigern_s2191_f1	UN-Teamkeywordtag Zutrittkeywordtag 	verweigert 	
verweigern_s2193_f1	Irakkeywordtag 	verweigerte 	auch am Montag einer Gruppe von Inspektoren der Vereinten Nationen ( UN ) den Zutritt zum Landwirtschaftsministerium in Bagdad . 
verweigern_s2726_f1	Überdies kann nicht einmal diese vom Parlament gebilligte `` Reform '' in Kraft treten , weil Staatspräsident Turgut Özal bisher seine Unterschrift 	verweigert 	- dem Staatschef sind die neuen Gesetze zu lasch . 
verweigern_s4264_f1	Da in der Regel auch andere Insolvenz-Versicherungen solchen Unternehmen die vorgeschriebene Absicherung der Kundengelder für den Pleitefall 	verweigerten 	, bedeute dies praktisch das Aus für sie . 
verweigern_s6237_f1	Die Königlich-Kanadische berittene Polizei , diekeywordtag jeden Kommentar 	verweigerte 	, will alle Aspekte untersuchen . 
verweigern_s7475_f1	Die Stadt könnte sich darauf verlassen , daß ihrkeywordtag das Geld nicht 	verweigert 	wird , das sie braucht . 
verweigern_s10872_f1	Daskeywordtag war der 45jährigen Paramonowa von der von Nationalisten und Kommunisten beherrschten Duma zweimal 	verweigert 	worden . 
verweigern_s12936_f1	Auch das Okay zu einem beantragten Rationalisierungskartell hatte das Amt in der Hauptstadt 	verweigert 	. 
verweigern_s13843_f1	Das sichtbare Blut des Opfertiers läßt eine Heftigkeit der Sexualität unter ganz normalen Menschen ahnen , von der sich unsere Schulweisheit nichts träumen läßt - und erst recht nicht die sauertöpfische des Puck , derkeywordtag gleich nach seinem Auftritt von Love ' s Labour ' s Lost spricht und seinem Herrn Oberon nicht ohne Hinweis auf seine gehbehindernden Stöckelschuhe fast den Dienst 	verweigert 	. 
verweigern_s13870_f1	Bisher werden Gerichte hierzulande erst aktiv , wenn Gläubigern , Gesellschaftern oder Betriebsräten der Einblick in die Bücher 	verweigert 	wird und sie deshalb klagen . 
verweigern_s15115_f1	Einer Gruppe internationaler Friedensaktivisten haben indonesische Behörden am Donnerstag die Einreise nach Ost-Timor 	verweigert 	. 
verweigern_s18974_f1	Die beiden Koalitionsfraktionen setzten statt dessen einen Beschluß durch , in dem das Parlament feststellte , daß die Genehmigung von Garzweiler II zwar rechtsgültig sei , die tatsächliche Genehmigung für den Braunkohleabbau im nächsten Jahrhundert aber 	verweigert 	`` werden kann und werden muß , wenn schwere ökologische Schäden drohen und wenn der energiewirtschaftliche Bedarf sich gravierend ändern sollte '' . 
verweigern_s19131_f1	Schmude weiß , daß dreikeywordtag eskeywordtag 	verweigerten 	, zwei `` Wessis '' , den Ostdeutschen hatte aber seine Kirche schon geprüft . 
verweigern_s19410_f1	Die sogenannte Drittstaatenregelung 	verweigert 	etlichen Schutzsuchenden schon das Recht auf Gehör . 
verweigern_s22905_f1	Die türkische Regierung hat einer Parlamentarier-Delegation aus Nordrhein-Westfalen die Einreise in die Türkei mit der Begründung 	verweigert 	, die Reise sei für die beiderseitigen Beziehungen `` nicht förderlich '' . 
verweigern_s23224_f1	Die Kasseler Richter haben damit dem Bundesverwaltungsgericht die Gefolgschaft 	verweigert 	. 
verweigern_s24798_f1	Da sich die Düsseldorfer Landesregierung weigerte , die Bedingung der Türkei zu akzeptieren , wurde der nordrhein-westfälischen Delegation die Einreise 	verweigert 	- die FR berichtete . 
verweigern_s26824_f1	Was beispielsweise in Frankreich , skandinavischen Ländern und den USA seit Jahren amtlich anerkannt sei , werde hierzulande beharrlich 	verweigert 	. 
verweigern_s28809_f1	Angehörigen von in Bonn akkreditierten Mitarbeitern der demokratischen Medien Serbiens wird die Einreise jedoch 	verweigert 	. 
verweigern_s29842_f1	Allerdings sei `` so etwas schon mal passiert '' , habe der Opernintendant Einsparungenkeywordtag mit Verweis auf seinen Vertrag 	verweigert 	. 
verweigern_s31032_f1	Der 22jährige Sanitäter , der auf einem Stützpunkt in Schweinfurt stationiert ist , hatte im Oktober einen Einsatz unter UN-Kommando im ehemaligen Jugoslawien 	verweigert 	. 
verweigern_s31402_f1	Wenn die jugoslawische Regierung dem UN-Tribunal für Kriegsverbrechen die volle Zusammenarbeit 	verweigere 	, solle ein `` äußerer Sanktionsring '' gegen das aus Serbien und Montenegro bestehende Jugoslawien bestehen bleiben . 
verweigern_s34594_f1	Die Schule 	verweigerte 	jedoch die Annahme der Bronzeplaketten . 
verweigern_s35125_f1	Die Jugend 	verweigert 	sich , weil Gewerkschaften verkrustet und nicht attraktiv sind . 
