verzichten_s892_f1	Japankeywordtag 	verzichtete 	1951 im Friedensvertrag von San Francisco auf ihre Rückgabe . 
verzichten_s1423_f1	Rabins Koalitionsunterhändler Benjamin Ben-Elieser deutete im Rundfunk an , daß die Arbeitspartei auf die Unterstützung durch die Tsomet-Partei 	verzichten 	und nur mit dem linken Meretz-Block und der religiös ausgerichteten Schas-Partei koalieren könnte . 
verzichten_s1525_f1	Andernfalls werde Rußlandkeywordtag auf das bereits angebotene Hilfspaket von 24 Milliarden Dollar 	verzichten 	. 
verzichten_s2888_f1	In Stuttgart hingegen verstand der Monika Helbing zu sieben Jahren verurteilende Oberlandesgerichtssenat die Kronzeugen-Eigenschaft der Angeklagten dahingehend , daß erkeywordtag gleich auf die Ermittlung ganzer Tatkomplexe 	verzichtete 	und deutlich unter dem Antrag der Bundesanwaltschaft blieb . 
verzichten_s3578_f1	Viele Touristen 	verzichteten 	auf die Reise nach Spanien . 
verzichten_s4042_f1	Außerdem müsse die Bundesregierung auf den weiteren Abbau von Sozialleistungen 	verzichten 	. 
verzichten_s5240_f1	Wenn die Unternehmen der Metallverarbeitung garantieren , in den nächsten drei Jahren - auf betriebsbedingte Kündigungen zu verzichten , - 300 000 zusätzliche Arbeitsplätze zu schaffen , - außerdem 30 000 Langzeitarbeitslose einzustellen - sowie die Ausbildungsplätze um jährlich 5 Prozent zu steigern und wenn die Bundesregierung verbindlich erklärt , - bei der Novellierung des Arbeitsförderungsgesetzes auf die Kürzung des Arbeitslosengeldes und der Arbeitslosenhilfe zu verzichten und die Sozialhilfekriterien nicht zu verschlechtern , - eine Regelung zur Gewährleistung des Ausbildungsplatzangebotes entsprechend der Nachfrage zu schaffen , - Betriebe , die nicht oder zuwenig ausbilden , zum Lastenausgleich heranzuziehen , dann werde ich mich dafür einsetzen , - in 1997 Einkommenssteigerungen zu vereinbaren , die sich am Ausgleich der Preissteigerung orientieren , - und befristete Einarbeitungsabschläge für Langzeitarbeitslose zu ermöglichen . 
verzichten_s5250_f1	Gegen Ende dieses Jahres gälte es , Bilanz zu ziehen - ob zusätzliche Arbeitsplätze und Ausbildungsplätze geschaffen wurden - und die Bereitschaft besteht , - zusätzliche Langzeitarbeitslose einzustellen , - ob die Regierung auf Verschlechterungen im Sozialbereich 	verzichtet 	hat - mit einem Wort , ob Bundesregierung und Metallarbeitgeber zu konkreten Vereinbarungen im Kampf gegen die Arbeitslosigkeit bereit sind . 
verzichten_s5316_f1	Deshalb 	verzichte 	ichkeywordtag an dieser Stelle lieber auf den Beifall , will aber etwas Nachdenkliches dazu sagen . 
verzichten_s6473_f1	Nach monatelangen Verhandlungen sicherte das Bonner Unternehmen in einem Tarifvertrag zu , auf betriebsbedingte Kündigungen bis Ende 1997 zu verzichten . 
verzichten_s7099_f1	Er ist ein moralisches Wesen , daskeywordtag das Leben bejaht , 	verzichten 	und maßhalten kann und sich verantwortlich für andere , sich selbst und das nicht-menschliche Leben zeigt , durch und durch geprägt von der Idee der `` Co-Existenz '' . 
verzichten_s7384_f1	So ist die CDU Rechtsnachfolgerin von gleich zwei DDR-Parteien geworden - Bauernpartei und Ost-CDU - , weil siekeywordtag auf den großen Mitgliederstamm und die Parteiapparate nicht 	verzichten 	wollte . 
verzichten_s8154_f1	Auf die Retourkutsche , Walesa habe seine alten Ideale noch stärker im Stich gelassen als die Ex-Kommunisten die ihren , wird Kwasniewskikeywordtag hoffentlich großmütig 	verzichten 	. 
verzichten_s8226_f1	Diesekeywordtag sollen nun auch noch auf die Gewerbekapitalsteuer ( sechs Milliarden Mark ) und auf Teile der Gewerbeertragsteuer 	verzichten 	und dafür an der Umsatzsteuer beteiligt werden . 
verzichten_s9359_f1	Die Marine orientiert sich vor allem an Überwachungsaufgaben im Randmeer- sowie dem angrenzenden Hochseebereich , 	verzichtet 	auf ihr Strike-Potential und baut eine begrenzte Kapazität für humanitäre Unterstützung auch im globalen Rahmen auf . 
verzichten_s10066_f1	Wenn Kohls Kämmerer weiter in gewohnter Manier `` Punktlandungen '' übt , das `` Auf ohne Schwung '' verdrängt , Städten und Gemeinden die Einnahmequellen verstopft , ganze Unternehmenssteuern abschaffen will , großzügig über das `` Kavaliersdelikt '' der Steuerhinterziehungen hinwegsieht und damit auf dreistellige Milliardeneinnahmen 	verzichtet 	, brauchen weder Bonn noch die Hauptstädte in Europa die Debatte über die künftigen Mitgliedsländer der Währungsunion zu fürchten . 
verzichten_s11270_f1	Die Stadtverwaltung von Paris muß in diesem Jahr auf die norwegische Weihnachtstanne 	verzichten 	, die traditionell den Place de Tertre auf dem Montmartre schmückt . 
verzichten_s11340_f1	Viele , die dort eine Institution errichten oder werben möchten , wollen auf einen Wiedererkennungseffekt nicht 	verzichten 	, der durch die Nachahmung der graphischen Gestaltung ihrer Seiten gemindert werden könnte . 
verzichten_s11710_f1	Vielekeywordtag haben auf ein Studium 	verzichtet 	. 
verzichten_s12828_f1	Die Opposition hat der Bundesregierung vorgeworfen , siekeywordtag 	verzichte 	mit ihrem Haushalt 1996 auf eine aktive Gestaltung der Politik . 
verzichten_s12874_f1	In dem Gespräch am Dienstag nachmittag 	verzichteten 	die Innenpolitiker der Koalition deswegen erneut darauf , einen Beschluß über die erleichterte Einbürgerung zu formulieren . 
verzichten_s13038_f1	CDU/CSU-Fraktionschef Wolfgang Schäuble hatte am Dienstag nachmittag darauf 	verzichtet 	, die Abgeordneten über den Koalitionskompromiß zu verlängerten Ladenöffnungszeiten abstimmen zu lassen - das ließ Spekulationen wuchern , die der Unionsführung unangenehm sein müssen . 
verzichten_s13084_f1	Daß CDU/CSU-Fraktionschef Wolfgang Schäuble am Dienstagnachmittag darauf 	verzichtete 	, die Abgeordneten über den Koalitionskompromiß zu verlängerten Ladenöffnungszeiten abstimmen zu lassen , ließ öffentlich Spekulationen wuchern , die der Unionsführung unangehmen sein müssen . 
verzichten_s13621_f1	Powellkeywordtag 	verzichtet 	auf Kandidatur 
verzichten_s13624_f1	Erkeywordtag 	verzichte 	auf eine Kandidatur für jegliches politische Amt , da er nicht die Berufung für ein politisches Leben verspüre , erklärte Powell - er ist der erste Schwarze an der Spitze der US-Streitkräfte - zur Begründung seiner Entscheidung am Mittwoch auf einer Pressekonferenz in Alexandria bei Washington . 
verzichten_s14857_f1	Die Personalbehörden sollen nur darauf 	verzichten 	, den Quoten-Paragraphen anzuwenden . 
verzichten_s15015_f1	Er begrüßte zwar das Angebot , auf reale Einkommenssteigerungen zu verzichten und untertarifliche Bezahlung von Dauerarbeitslosen zu ermöglichen , lehnte aber die im Gegenzug von der IG Metall verlangten Leistungen von Bundesregierung und Wirtschaft ab . 
verzichten_s15811_f1	Der Axel Springer Verlag hatte kürzlich auf einen Einstieg 	verzichtet 	. 
verzichten_s15949_f1	Um diese Kosten aufzufangen , müßte die IG Metall nicht nur ein Jahr , sondern vier Jahre auf reale Lohnzuwächse 	verzichten 	. 
verzichten_s16110_f1	Auf eine namentliche Erwähnung Frankreichs oder Chinas , die beide noch Atomtests vornehmen , wurde 	verzichtet 	. 
verzichten_s16818_f1	Auf das eigene Auto kann mankeywordtag an der Waadtländer Riviera getrost 	verzichten 	; 
verzichten_s17347_f1	Als dann auch noch die Polizei erschien und von mir in gebieterischem Ton aus Gründen der Geheimhaltung meine Kamera verlangte , 	verzichtete 	ichkeywordtag auf eine Hafentour und suchte das Weite . 
verzichten_s17700_f1	Wenngleich ein internationaler Vergleich keine signifikante positive Beziehung zwischen einer Verringerung der durchschnittlichen individuellen Jahresarbeitszeit und einer Zunahme der Beschäftigung erkennen läßt , werden wirkeywordtag zur Abmilderung insbesondere kurzfristiger Beschäftigungsprobleme auf das Instrument der Arbeitszeitverkürzung nicht 	verzichten 	können . 
verzichten_s18546_f1	Wie mutmaßlich bei Frau Ziegler aus Zug C , diekeywordtag bereits am Montag abend `` stark schwirbelt '' , desorientiert ist und am Donnerstag sogar auf den Höhepunkt , die Privataudienz beim Papst , 	verzichten 	muß . 
verzichten_s18959_f1	Der 45jährige Regierungskoordinator Jan Nygren 	verzichtet 	aus familiären Gründen auf den Posten , der ihm andernfalls nun sicher gewesen wäre . 
verzichten_s20710_f1	Das DDR-Parlament habe 1990 bewußt auf eine Amnestie 	verzichtet 	, habe diese Verfahren gewollt . 
verzichten_s22243_f1	Im Gegenzug verlangt der Gewerkschafter von den Arbeitgebern die Zusage , in den nächsten drei Jahren auf betriebsbedingte Kündigungen zu verzichten , 300 000 zusätzliche Arbeitsplätze zu schaffen , 30 000 Langzeitarbeitslose einzustellen sowie die Zahl der Lehrstellen um fünf Prozent per annum zu steigern . 
verzichten_s22244_f1	Die Regierung sollte auf die Kürzung von Arbeitslosengeld und -hilfe 	verzichten 	und eine Regelung für ein größeres Ausbildungsplatzangebot finden . 
verzichten_s22644_f1	Angeblich stehen beide Seiten kurz vor einer Einigung , wonach Hamaskeywordtag zukünftig auf Gewalt 	verzichten 	und an den Wahlen teilnehmen werde . 
verzichten_s22773_f1	Während der Staat einerseits jährlich 400 Millionen Mark in die Krebsforschung stecke , wolle erkeywordtag andererseits nicht auf rund 20 Milliarden Mark Einnahmen aus der Tabaksteuer 	verzichten 	. 
verzichten_s23075_f1	Wir hoffen von ganzem Herzen , daß alle Parteien darauf 	verzichten 	werden , Positionen einzunehmen , die zu weiteren Tragödien führen könnten . '' 
verzichten_s24203_f1	Das hängt wohl damit zusammen , daß diese Frauen - meist länger und besser ausgebildet - häufig Kinder erst relativ spät gebären oder ganz auf Nachwuchs 	verzichten 	. 
verzichten_s24281_f1	Die Gier nach flächendeckender Musicalisierung glaubt allmählich , ganz auf Boulevard- und Großstadtambiente ( das , wie lausig auch immer , sogar in Offenbach noch gegeben ist ) 	verzichten 	zu können . 
verzichten_s24324_f1	Als Ausdruck für die Akzeptanz der Vielfalt schlägt die Kommission daher vor , auf eine Amtssprache zu verzichten und jedem Eritreer das Recht zu geben , die Sprache seiner Wahl zu sprechen . 
verzichten_s24553_f1	Die Wärmeabgabe von Heizkörpern und die Luftzirkulation an den Außenwänden lassen sich häufig verbessern , indem mankeywordtag beispielsweise auf bodenlange Vorhänge 	verzichtet 	oder die Möbel nicht zu dicht an die Wand stellt . 
verzichten_s25373_f1	Es war wohl die Furcht , sich selbst einen letzten Fußtritt zu geben , gepaart mit der Scheu , den Medien ein neues Spektakel zu bieten , daß der Parteitag auf die von vielen erwartete Selbstzerfleischung 	verzichtete 	. 
verzichten_s25469_f1	Die FDP-Bundestagsfraktion hat Bundesinnenminister Manfred Kanther aufgefordert , auf Abschiebungen von Ausländern zunächst zu verzichten und Entscheidungen des Parlaments zum Aufenthaltsrecht für Bürgerkriegsflüchtlinge und für Altfälle abzuwarten . 
verzichten_s26168_f1	Umgekehrt schafft die Bereitschaft von sozialen Gruppen und Nationen , sich mit eigenen Fähigkeiten und natürlichen Ressourcen zufriedenzugeben und darauf zu verzichten , den eigenen Wohlstand auf Kosten anderer zu vermehren , erst die Grundlage dafür , daß Menschen untereinander wie auch mit der Natur Frieden schließen . 
verzichten_s26990_f1	`` Die SPD ist reich an Begabungen , aber nicht so reich , daß siekeywordtag auf Begabungen 	verzichten 	kann . '' 
verzichten_s28249_f1	Ein namentlich nicht genanntes Mitglied der serbischen Delegation drohte am Mittwoch mit dem Scheitern der Konferenz , falls die moslemische Seite nicht auf ihre `` unrealen '' Gebietsforderungen 	verzichte 	. 
verzichten_s28491_f1	Im Gegenzug für die Begrenzung der Schadstoffe 	verzichtete 	Rotterdamkeywordtag auf mögliche Schadenersatzforderungen gegen die VCI-Mitgliedsfirmen , teilte der Verband am Donnerstag in Frankfurt mit . 
verzichten_s28834_f1	Eskeywordtag 	verzichtete 	, nach den obligaten Verbeugungen vor dem Folkloristen ( `` Tanz-Suite '' , `` Bildern aus Ungarn '' ) , ganz auf eingängige Stücke und holte mit Bartóks Bühnenwerken und Klavierkonzerten eher das Experimentelle , Sperrige , Vielschichtige aus seinem Werk hervor . 
verzichten_s28934_f1	In seinem anspruchsvollen Versuch , eine Theologie zu formulieren , diekeywordtag auf absolute Wahrheiten 	verzichtet 	und für `` Kirche als Überzeugungsgemeinschaft '' plädiert , zeigte sich Eid erheblich näher an der modernen Debatte als Küng . 
verzichten_s29470_f1	Das wird zuerst daran deutlich , daß in der neuen Verfassung auf eine Sonderrolle der Partei 	verzichtet 	wurde . 
verzichten_s30013_f1	Eiskalt lehnt Clinton am Donnerstag auch Angebote der Republikaner ab , auf Einschnitte bei der Gesundheitsversorgung zu verzichten , wenn der Präsident nur dem Ziel der Sieben-Jahres-Haushaltspolitik zustimme . 
verzichten_s30366_f1	Am Mittwochabend hatte das von den Republikanern beherrschte Abgeordnetenhaus auf bislang erhobene Forderungen nach tiefen Einschnitten bei der Gesundheitsversorgung für ältere Menschen 	verzichtet 	. 
verzichten_s30396_f1	Um einen Konkurs abzuwenden , 	verzichtet 	der Vulkan als Hauptgläubiger gegen Besserungsschein auf Forderungen von bis zu 170 Millionen . 
verzichten_s31196_f1	Auf weitere rechtliche Auseinandersetzungen wolle Syncronyskeywordtag aber 	verzichten 	, da man vor einem Gericht keine technische Debatte führen könne . 
verzichten_s31298_f1	Danach 	verzichtet 	der Hafen Rotterdam im Gegenzug für die Schadstoffsenkung auf Schadenersatzforderungen gegen die rund 50 deutschen Chemiefirmen entlang des Rheins und seiner Nebenflüsse . 
verzichten_s31703_f1	Das Lebensalter lasse keine Rückschlüsse auf `` Expeditions-Eignung '' zu , gefragt seien vor allem `` Toleranz , Humor , Geduld und die Bereitschaft , auf Komfort zu verzichten und mit anzupacken '' , heißt es im Katalog `` Extremlandschaften der Erde '' von Geo-Tours , Schopstraße 17 , 20255 Hamburg , Tel. 0 40 / 4 91 98 32 . 
verzichten_s31823_f1	`` Zum Beispiel Rinderroulade , auf die siekeywordtag drüben 	verzichten 	mußten , Steak oder ein typisches amerikanisches Gericht '' , erklärt Woelki . 
verzichten_s31991_f1	Bei der Auswahl der Feriendörfer in Österreich und Italien wurden Orte mit gewachsenen Strukturen bevorzugt und auf Betonburgen als Unterkünfte 	verzichtet 	. 
verzichten_s32119_f1	Das aber bedeutet nichts anderes , als daß mankeywordtag das Individuum aus seiner Verantwortung entläßt und damit auf jene strapaziösen Auseinandersetzungen 	verzichtet 	, ohne die es demokratisch zustande gekommene Lösungen nicht geben kann . 
verzichten_s32404_f1	Auch Fritz Pleitgen mochte in seiner Runde , zu der er sich immerhin fünf journalistische Expertinnen eingeladen hatte , partout nicht auf die Querelen um den Tagungsort 	verzichten 	, obwohl die Kolleginnen ihm mit engelshafter Geduld und vereinten Kräften immer wieder erklärten , daß die Entscheidung für diesen Ort 1992 fast ausschließlich von Männern gefällt worden war . 
verzichten_s33334_f1	Die SPD ist dafür , daß der moderne Staat auf unnötige Reglementierungen und gesetzliche Detailregelungen 	verzichtet 	. 
verzichten_s34376_f1	Gingrichkeywordtag 	verzichtet 	auf Präsidentenkandidatur 
verzichten_s35028_f1	Die öffentliche Verschuldung muß vielmehr zunehmen , wenn auf Umverteilungen 	verzichtet 	wird , und sie läßt sich ohne Steuererhöhungen nicht reduzieren . 
verzichten_s35273_f1	Dem wird nicht gerecht , wer sich in eine falsche Alternative drängen läßt : hier die Strategen , die nur auf Gysis schöne moderne Verpackung deuten und in Wahrheit der Mehrheit wegen eiskalt und geschichtsvergessen mit dem Teufel paktieren , dort die politisch-moralisch Intakten , diekeywordtag , allein die `` alten Kader '' im Blick , lieber aufs Regieren 	verzichten 	, als sich der `` Nachfolgepartei '' an den Hals zu werfen . 
verzichten_s35323_f2	Wobei die Briten auf ihre Perücken und die Franzosen auf die Barette 	verzichteten 	; 
verzichten_s35681_f1	Müller löst Bundesbauminister Klaus Töpfer als Vorsitzenden ab , derkeywordtag nach einer monatelangen parteiinternen Debatte über die künftige Führungsstruktur der Union im Saarland im Juni auf eine erneute Kandidatur 	verzichtet 	hatte . 
verzichten_s37243_f1	Dank der Begeisterung der Massen und der kostenlosen Medienberichterstattung über den 15 Millionen Pfund schweren Shearer-Deal könne Hallkeywordtag auf teure Werbung für die Emission praktisch 	verzichten 	- und sich statt der bescheiden geplanten 150 Millionen gut und gerne 170 Millionen Pfund auf dem Kapitalmarkt holen . 
verzichten_s39592_f1	Als Premiere feiert der Vorstand zudem , daß erkeywordtag auf neue Kredite 	verzichten 	konnte . 
