widersprechen_s3589_f1	Hessens Finanzministerin Annette Fugmann-Heesing ( SPD ) hat der Absicht ihres Bonner Kollegen Theo Waigel ( CSU ) 	widersprochen 	, die Altschulden der Treuhandanstalt und des Kreditabwicklungsfonds von voraussichtlich 350 Milliarden Mark teilweise auf die alten Länder abzuwälzen . 
widersprechen_s4253_f1	Das Aussehen der geschmolzenen Metallteile sowie Zeugenaussagen 	widersprächen 	allen Spekulationen über einen möglichen Terrorakt . 
widersprechen_s5380_f1	Dem naheliegenden Mißverständnis , daß es sich hier um einen kalifornischen Werbespot für verwöhnte Jugendliche ( oder eine schlechte TV-Serie für die gleiche Zielgruppe ) handelt , 	widerspricht 	die als Erzählerin munter aus dem Off plappernde Cher bereits in der ersten Szene . 
widersprechen_s5737_f1	Daskeywordtag 	widerspricht 	absolut jeder jüdischen Tradition . 
widersprechen_s7366_f1	`` Die Selbstdarstellung der CDU 	widerspricht 	der eigenen Praxis '' / 
widersprechen_s7392_f1	Die Selbstdarstellung der CDU als Bollwerk gegen die SED-Nachfolgepartei PDS 	widerspricht 	ihrer eigenen Praxis . 
widersprechen_s8949_f1	Im konkreten Fall 	widersprachen 	die Bundesrichter einem Urteil des Oberverwaltungsgerichts Koblenz . 
widersprechen_s10151_f1	Telegrafisch erinnerte etwa der IG-Metall-Vorsitzende Klaus Zwickel daran , daß seine Organisation dieser Namensgebung 	widersprochen 	habe , weil es keinen festumrissenen Wirtschaftszweig Umwelt gebe . 
widersprechen_s10349_f1	Ohne Löwerkeywordtag in dem Punkt und der Frage nach Geheimhaltung ausdrücklich zu widersprechen , setzten der renommierte Kölner Steueranwalt Günther Felix und der frühere Präsident des Münchener Bundesfinanzhofs , Franz Klein , etwas andere Akzente . 
widersprechen_s12309_f1	doch beide konstruieren in Wahrheit eine neue kulturelle Landkarte , diekeywordtag der industriellen Moderne entspringt , statt ihrkeywordtag zu widersprechen . 
widersprechen_s13525_f1	Vehement 	widerspricht 	eskeywordtag der BRH-Feststellung , die Zinsen auf die Altkredite seien künstlich überhöht gewesen oder hätten den Aufbau im Osten beeinträchtigt . 
widersprechen_s14628_f1	Diesem Vorbehalt 	widerspricht 	auf der Göttinger Tagung die niedersächsische Justizministerin Heidi Alm-Merk ( SPD ) . 
widersprechen_s14706_f1	Begründung : Es 	widerspreche 	der Lebenserfahrung , daß Malerarbeiten an der Tür vergeben und diese sofort ausgeführt werden . 
widersprechen_s14915_f2	Siekeywordtag erhebt die konservative Gegenrevolution zum Programm , schließt weitreichende Reformen aus , 	widerspricht 	volkswirtschaftlicher Vernunft , verhindert den gesellschaftlichen Interessenausgleich und setzt letztlich die Zukunftsfähigkeit unserer Gesellschaft aufs Spiel . 
widersprechen_s15468_f1	In einem Brief an Hessens Innenminister Gerhard Bökel ( SPD ) lehnte Kanther es ab , den hessischen Abschiebeschutz zu verlängern , weil erkeywordtag `` Sinn und Zweck '' des eingeschränkten Bonner Asylrechts 	widerspreche 	. 
widersprechen_s16012_f1	Der UN-Vertreter 	widersprach 	zudem Berichten des kroatischen Fernsehens , wonach die UN mehrere Beobachtungsposten in Ostslawonien geräumt hätten . 
widersprechen_s18081_f2	Siekeywordtag erhebt die konservative Gegenrevolution zum Programm , schließt weitreichende Reformen aus , 	widerspricht 	volkswirtschaftlicher Vernunft , verhindert den gesellschaftlichen Interessenausgleich und setzt letztlich die Zukunftsfähigkeit unserer Gesellschaft aufs Spiel . 
widersprechen_s18562_f1	Constantin von Brandenstein 	widerspricht 	empört . 
widersprechen_s19250_f1	Von Partei-Vize Heidi Wieczorek-Zeul ist aber bekannt , daß siekeywordtag diesem Plan 	widerspricht 	und `` Klärung unserer außenpolitischen Positionen jetzt '' verlangt . 
widersprechen_s19451_f1	Die Tötung der Ogoni-Aktivisten 	widerspreche 	allen Werten zivilisierter Gesellschaften . 
widersprechen_s20023_f1	Alt ist er nicht geworden , der Unglücksrabe von der klapprigen Gestalt , der dem saturierten goldenen Oscar die Stirn bieten wollte und dessen Entwicklung seinem Namen stets 	widersprach 	. 
widersprechen_s20990_f1	Am Sonntag hatte bei vielen Wahllokalen in Baku augenscheinlich wenig Andrang geherrscht , waskeywordtag den offiziellen Angaben zu widersprechen schien . 
widersprechen_s21983_f1	Die Festlegung einer Mindestquote für Frauen entsprechend dem Mitgliederanteil 	widerspricht 	dem Demokratieprinzip . 
widersprechen_s22122_f1	Die Bilder dem Wissen 	widersprechen 	zu lassen ist gerade die Strategie von Volker Koepps Kalter Heimat Ostpreußen . 
widersprechen_s23049_f1	Nachdrücklich 	widersprechen 	auch Londoner Afrika-Experten wie der frühere Herausgeber des West Africa Magazine , Ad ' Obe Obe , der These Majorskeywordtag . 
widersprechen_s23220_f1	Hessischer VGH 	widerspricht 	dem Bundesverwaltungsgericht 
widersprechen_s23928_f1	Reinhold Grimm 	widersprach 	dieser landläufigen Interpretation und wies auf die alte Tradition des deutschen Dramas von Grabbe und Büchner bis zu Wedekind hin . 
widersprechen_s27781_f1	Der indirekten Aufforderung Naumannskeywordtag , die Verwendung des Tucholsky-Zitats schärfer zu ahnden , 	widersprach 	der Bundespräsident - ebenso indirekt . 
widersprechen_s28652_f1		Widersprochen 	wird ihmkeywordtag vom jüngeren Freund Lessing , für den die Vaterlandsliebe eine `` heroische Schwachheit '' istkeywordtag . 
widersprechen_s33320_f1	Lafontainekeywordtag 	widersprach 	am Abend der Darstellung , daß seine Wahl einen Linksruck in der SPD bedeute . 
widersprechen_s33607_f1	Die Anwohner 	widersprachen 	in ihren schriftlich niedergelegten Aussagen auch der Behauptung der Polizei , ein erster Streifenwagen sei `` Sekunden nach '' der ersten Brandmeldung um 1.03 vor dem brennenden Haus in der Sachsenstraße erschienen . 
widersprechen_s35913_f1	Das Verteidigungsministerium 	widersprach 	zudem einer Meldung des Spiegel , der leichte Jagdflieger `` Eurofighter '' solle zum schweren Bomber umgerüstet werden . 
widersprechen_s37001_f1	Demkeywordtag 	widerspricht 	allerdings Bernd Ellermann von der Vereinten Versicherung in München . 
widersprechen_s38732_f1	Technisch sei dies machbar , 	widersprach 	Starzacherkeywordtag den Skeptikern in der Verwaltung . 
widersprechen_s39212_f1	Der Verkauf von mehr als 50 Prozent der Anteile an ein ausländisches Unternehmen 	widerspreche 	nationalen Sicherheitsinteressen . 
