zerstoeren_s999_f1	Bei Sprengstoffanschlägen haben am Samstag in der nordspanischen Stadt Fuenterrabia Unbekanntekeywordtag sieben Autos 	zerstört 	. 
zerstoeren_s1085_f1	Außerdem habe der Kongreß die gerichtliche Verfolgung Gorbatschows gefordert , weil dieserkeywordtag `` den Staat 	zerstört 	'' habe . 
zerstoeren_s1195_f1	Nicht nur , daß man als Gastgeber nicht habe für das Leben der israelischen Sportler garantieren können , auch etwas von dem neuen Zutrauen zwischen der Bundesrepublik und Israel sei durch diesen Terroranschlag 	zerstört 	worden . 
zerstoeren_s1485_f1	UN : C-Waffenlagerkeywordtag 	zerstört 	
zerstoeren_s1487_f1	Das irakische Chemiewaffenpotential ist nach Angaben der Vereinten Nationen ( UN ) weitgehend 	zerstört 	. 
zerstoeren_s1492_f1	Irakkeywordtag ist gemäß der Waffenstillstandsresolution zur Beendigung des Golf-Krieges verpflichtet , seine Massenvernichtungswaffen und deren Produktionsanlagen unter Aufsicht der UN zu zerstören . 
zerstoeren_s3506_f1	Die Erfahrung in der Dritten Welt hat gezeigt , daß Schocktherapien nach dem Rezept des Internationalen Währungsfonds die ökonomische und politische Basis 	zerstören 	, aus der heraus neue marktwirtschaftliche Triebe sprießen sollen . 
zerstoeren_s4113_f1	`` Angelakeywordtag '' 	zerstörte 	Tausende Häuser und ließ die Stromversorgung in weiten Teilen des Landes zusammenbrechen . 
zerstoeren_s4251_f1	Das Feuer , daskeywordtag die Waggons 	zerstörte 	, sei unter einem Waggon nahe einer Achsen-Aufhängung ausgebrochen , sagte der schwedische Experte Kurt Nielsen . 
zerstoeren_s4310_f1	Der erste Herbststurm dieses Jahres entwurzelte Bäume , deckte Dächer ab , 	zerstörte 	Strom- und andere Versorgungsleitungen . 
zerstoeren_s4461_f1	Bei den Explosionen am Freitag waren ganze Viertel der 30000-Einwohner-Stadt in der Provinz Cordoba 	zerstört 	worden . 
zerstoeren_s4550_f1	Gewaltkeywordtag 	zerstört 	die Grundlage der israelischen Demokratie . 
zerstoeren_s4614_f1	Die Schüsse 	zerstörten 	den Ruf der Geheimdienste 
zerstoeren_s4617_f1	Die Ermordung Yitzhak Rabins hat in Israel den Mythos von der totalen Effizienz der Geheimdienste 	zerstört 	. 
zerstoeren_s4724_f1	Denn siekeywordtag 	zerstören 	nur die Gemeinschaft . '' 
zerstoeren_s5501_f1	Keine Zeile , diekeywordtag nicht verdreht , verstümmelt , 	zerstört 	würde . 
zerstoeren_s5610_f1	Ein Tabu ist in Israel 	zerstört 	worden , das tief im kollektiven Bewußtsein verankert ist : 
zerstoeren_s5624_f1	In diesem Sinne - und man kommt nicht daran vorbei , sich um Yassir Arafat zu sorgen - können Mordekeywordtag Friedensprozessekeywordtag 	zerstören 	. 
zerstoeren_s6694_f1	Wo diese Strukturen bereits 	zerstört 	seien , müsse man alles daran setzen , sie wiederherzustellen . 
zerstoeren_s6815_f1	Wohlmeinende Umwelt- und Tierschützer würden zu wenig beachten , daß das Importverbot Lebensgrundlagen vieler Ureinwohner 	zerstören 	könnten . 
zerstoeren_s7444_f1	Mit welchem Programm , mit welchen Sachforderungen können wir stärker werden , Profil gewinnen , Menschen gewinnen , diekeywordtag jetzt vorgebracht erst gar keine Koalition entstehen lassen - und später vorgebracht , den Vorwurf eintragen , die Koalition zu zerstören . 
zerstoeren_s9023_f1	Feuerkeywordtag 	zerstört 	Palast der Königin 
zerstoeren_s11365_f1	Sie wissen , ebenso wie wir , deswegen nur zu gut , was Kommunismus bedeutete und mit welch ausgeklügelten Methoden erkeywordtag Rückgrate zu verkrümmen und menschliche Seelen zu zerstören vermochte . 
zerstoeren_s11499_f1	Der stets grimmig , aber zutraulich dreinblickende Kommunistenführer weiß , was die Parteiveteranen von ihm hören wollen : Daß die Jelzin-Clique sie um die Errungenschaften ihres redlichen Lebens betrogen , das Land 	zerstört 	und ausgeraubt habe , daß die `` Völker der Sowjetunion wieder zum Zusammenschluß bereit '' seien . 
zerstoeren_s13589_f1	Sie werfen vor allem dem Shell-Konzern vor , erkeywordtag beute die Region aus , 	zerstöre 	die Natur und beraube die Ogoni so ihrer Lebensgrundlagen . 
zerstoeren_s14801_f1	Immerhin fällt einem Synodalen der Schacher um die Posten als `` reaktionärer Provinzialismus '' auf , derkeywordtag , verschwände er nicht ganz schnell in der Rumpelkammer der Geschichte , `` die Vision einer europäischen Synode '' ein für allemal 	zerstöre 	. 
zerstoeren_s14827_f1	Die vier Bomben wurden 	zerstört 	und ihr radioaktiver Inhalt leckte aus . 
zerstoeren_s14924_f1	- Ein Blick auf die sozialen Folgen von Ausbeutung und die Umweltzerstörung zeigt , daß eine an kurzfristiger Gewinnerzielung von Einzelunternehmen orientierte Wirtschaftspolitik die Zukunft verspielt , weil siekeywordtag die humane und ökologische Substanz der Wertschöpfung 	zerstört 	. 
zerstoeren_s16519_f1	Die Altstadt wurde im Krieg nicht 	zerstört 	. 
zerstoeren_s17116_f1	Dieser Spiegel darf auf seiner weiten Bahn um die Erde niemals das Licht der Sonne erblicken , weil dadurchkeywordtag die empfindlichen Meßgeräte 	zerstört 	würden . 
zerstoeren_s17961_f1	Da die Wehrmacht befehlsgemäß auch die Transportwege systematisch 	zerstörte 	und Brücken selbst über unbedeutende Wasserläufe gesprengt wurden , waren auch diejenigen Agrargebiete von den Städten abgeschnitten , in denen noch geerntet werden konnte . 
zerstoeren_s18090_f1	- Ein Blick auf die sozialen Folgen von Ausbeutung und die Umweltzerstörung zeigt , daß eine an kurzfristiger Gewinnerzielung von Einzelunternehmen orientierte Wirtschaftspolitik die Zukunft verspielt , weil siekeywordtag die humane und ökologische Substanz der Wertschöpfung 	zerstört 	. 
zerstoeren_s20519_f1	Traurige Berühmtheit hat 1990 das Massaker von Umuechem erlangt , bei dem Sonderkommandos der Polizei , die zum Teil mit Shell-Werksbussen herangekarrt worden waren , Dutzende von Menschen töteten und Hunderte von Häusern 	zerstörten 	. 
zerstoeren_s20525_f1	Soldaten und Angehörige einer Spezialtruppe der Polizei fielen in den nächsten Tagen und Wochen über die Ogoni her , töteten mindestens 50 Menschen , vergewaltigten Frauen , 	zerstörten 	Häuserkeywordtag und nahmen Massenverhaftungen vor . 
zerstoeren_s21639_f1	Die starke Aufwertung der Mark und die hohen Tarifabschlüsse hätten diese Hoffnung 	zerstört 	, erklären die `` Weisen '' nun . 
zerstoeren_s21908_f1	Das Übergewicht von `` nackten '' Tatsachen gegenüber der Analyse , von Veränderung gegenüber Kontinuität kann in den Zuschauern ein fragmentiertes Weltbild erzeugen und insbesondere das Gefühl einer Verbundenheit mit der Natur oder der Vergangenheit 	zerstören 	. 
zerstoeren_s23271_f1	`` Durch unsere gedankenlose Handlungsweise 	zerstören 	wirkeywordtag dieses biologische Kapital mit einer alarmierenden Geschwindigkeit . '' 
zerstoeren_s23577_f1	Die LTTE warf in einer Erklärung den Regierungstruppen vor , bei ihrem Vormarsch Häuser der aus dem Kriegsgebiet geflohenen tamilischen Bevölkerung zu zerstören . 
zerstoeren_s25889_f1	`` Wenn Rußland den Vertrag vollständig erfüllt , dann wird das Sicherheitssystem des Landes , besonders an den südlichen und nördlichen Flanken vollständig 	zerstört 	'' , sagte Verteidigungsminister Pawel Gratschow . 
zerstoeren_s29177_f1	Daran knüpft sie aber gleich die Befürchtung , daß die Investitionen zu Lasten der Ökologie gehen und die wenigen natürlichen Ressourcen des Fernen Ostens 	zerstören 	könnten . 
zerstoeren_s29234_f1	Wenn es nicht gelingt , eine Bühne im Mittelpunkt des Interesses ihrer Region zu halten , ist siekeywordtag 	zerstört 	. 
zerstoeren_s30433_f1	`` ... In den letzten 40 Monaten haben die 30 Teilnehmerstaaten beinahe 50 000 Waffensysteme 	zerstört 	oder für eine zivile Verwendung umgerüstet . 
zerstoeren_s32168_f1	Atomwaffen symbolisieren , wie mittlerweile die gesamte technische Entwicklung auch , daß der Mensch seine Existenzgrundlagen 	zerstören 	kann . 
zerstoeren_s33301_f1	Die Meuterer nahmen Geiseln , die sie später freiließen , legten Feuer und 	zerstörten 	Inventarkeywordtag . 
zerstoeren_s33774_f1	Viele Wände in der Haftanstalt wurden eingerissen , Mobiliar und sanitäre Anlagen fast vollständig 	zerstört 	. 
zerstoeren_s33818_f1	Der Patriarch braucht Unterstützung bei der Abwehr religiöser Konkurrenz - `` Sekten und pseudo-religiöse Gruppen '' , diekeywordtag `` von außen '' ins Land drängten und die `` allgemeinen sittlichen Werte '' 	zerstörten 	. 
zerstoeren_s34919_f1	War doch durch seinen Eingriff ihre Vorstellung 	zerstört 	worden , der Nürnberger Prozeß könnte gerecht und eindeutig und für alle Zukunft die Bösen von den Guten trennen . 
zerstoeren_s34939_f1	Inmitten des aufgeklärten Europas wurde von Deutschen die Zivilisation radikal 	zerstört 	. 
zerstoeren_s35779_f1	In den Gemeinschafts- und Verwaltungsräumen sind alle Einrichtungsgegenstände 	zerstört 	. 
