zurueckkehren_s1174_f0	Die Heilsfront forderte Kafikeywordtag auf , zu demokratischen Reformen 	zurückzukehren 	. 
zurueckkehren_s1630_f0	Vom künftigen Grenzverlauf wird abhängen , wie viele der rund 200 000 griechischen Zyprioten , die 1974 vor den türkischen Besatzern in den Süden flohen , wieder in ihre Heimatorte 	zurückkehren 	können . 
zurueckkehren_s4150_f0	`` Columbiakeywordtag '' sicher zur Erde 	zurückgekehrt 	
zurueckkehren_s4152_f0	Nach 16 Tagen im All ist die US-amerikanische Raumfähre `` Columbia '' am Sonntag sicher zur Erde 	zurückgekehrt 	. 
zurueckkehren_s4754_f0	Zwar kam es zu einer Übereinkunft in den 80er Jahren , aber bislang sind nur wenige der `` expulsados '' 	zurückgekehrt 	. 
zurueckkehren_s4760_f0	Doch Domingo Angel Gonzalez , Pastor und Anführer der Ausgestoßenen , besteht darauf , seine Landsleute `` eines Tages '' nach San Juan Chamula 	zurückkehren 	. 
zurueckkehren_s5504_f0	Unter dieser Voraussetzung läßt sich zwangsläufig nichts mehr erkennen von der poetischen Metapher für die Zerbrechlichkeit der Welt und das Schwankende der Empfindungen , welche Kleist an dem mythischen Stoff des nächtlichen Besuchs von Jupiter bei Alkmene entfaltet , der sich der Gott als ihr Mann Amphitryon ausgibt ( bis dieser Feldherr später selber 	zurückkehrt 	- und nichts kann dann noch sein wie zuvor ) . 
zurueckkehren_s6547_f0	Er werde vorgeladen , sobald erkeywordtag von einer Auslandsreise 	zurückgekehrt 	sei , sagte die Staatsanwaltschaft . 
zurueckkehren_s7076_f0	Der Erzähler , Dramatiker und Essayist hat in Großbritannien studiert und war 1960 in seine Heimat 	zurückgekehrt 	, wo er während des Biafra-Kriegs 1968 / 69 inhaftiert wurde . 
zurueckkehren_s9106_f0	In Zaire halten sich etwa eine Million ruandische Hutu-Flüchtlinge auf , diekeywordtag aus Angst vor Repressalien der Tutsi nicht in ihre Heimat 	zurückkehren 	wollen . 
zurueckkehren_s10744_f0	Beide Kriegsparteien drängten siekeywordtag , an den Verhandlungstisch 	zurückzukehren 	. 
zurueckkehren_s11759_f0	Auch den 30 eingeschriebenen halleschen Mitgliedern des Corps Palaiomarchiae , daskeywordtag nach dem Ende der DDR an die ostdeutschen Universitäten 	zurückkehrte 	, wirft Scherer `` verstaubtes Elitedenken , Frauenfeindlichkeit und eine fehlende kritische Auseinandersetzung mit der eigenen NS-Vergangenheit '' vor . 
zurueckkehren_s11788_f0	Bereits im vergangenen Jahr hatten sich die Kösener Corps entschlossen , so KSCV-Sprecher Oliver Senger , `` nach rund 60 Jahren Vertreibung wieder an die Stätte der Gründung ins benachbarte Bad Kösen 	zurückzukehren 	'' . 
zurueckkehren_s11800_f0	Die Gemeinschaft befinde sich in Aufbruchstimmung , da siekeywordtag nun in ostdeutsche Hochschulen 	zurückkehren 	und einen Teil der Erziehung übernehmen könne . 
zurueckkehren_s12713_f0	Die Frau war in die DDR 	zurückgekehrt 	, weil , wie sie angab , ihr zurückgebliebener Mann sei von den DDR-Behörden unter Druck gesetzt worden . 
zurueckkehren_s12767_f0	So bleibt es nationalen Regelungen vorbehalten , wie sie sicherstellen , daß ein Beschäftigter nach dem Sonderurlaub auf die alte oder eine gleichwertige Stelle 	zurückkehren 	kann , und welche Möglichkeiten es geben wird , die Auszeit in Etappen oder halbtags zu nehmen . 
zurueckkehren_s12820_f0	Fast 5000 Kindersoldaten , davon etwa ein Drittel jünger als zwölf Jahre , sind nach Schilderung von Tarneden bis heute noch nicht wieder in ein normales Leben 	zurückgekehrt 	. 
zurueckkehren_s12868_f0	Sogenannte Gastarbeiter sollen jederzeit nach Deutschland 	zurückkehren 	können , wenn sie mindestens 15 Jahre rechtmäßig hier gelebt haben und über `` ausreichend '' Rente sowie Krankheitsschutz verfügen . 
zurueckkehren_s13536_f0	Die Vertriebenen forderten deshalb die Vereinten Nationen , das Internationale Komitee des Roten Kreuzes und Menschenrechtsorganisationen auf , sich dafür einzusetzen , daß die Menschen in ihre Heimat 	zurückkehren 	könnten . 
zurueckkehren_s14111_f0	Neu ist , daß sie vermehrt Studenten und Intellektuelle , diekeywordtag für kurze Familienbesuche aus dem Ausland nach Tunesien 	zurückkehren 	, verhaftet und hinter Gitter bringt . 
zurueckkehren_s15068_f0	Den Haftbefehl hatte die Staatsanwaltschaft am Mittwoch erwirkt , nachdem ihr bekanntgeworden war , Deckertkeywordtag werde am Abend von einer zweiwöchigen Reise auf die Kanarischen Inseln 	zurückkehren 	. 
zurueckkehren_s17373_f0	Mein Gepäck war tatsächlich aus Katmandu 	zurückgekehrt 	, meinem Weiterflug noch in dieser Nacht stand damit nichts mehr im Wege . 
zurueckkehren_s19842_f0	Die Unterzeichner forderten die Weltöffentlichtkeit auf , Druck auf die srilankische Regierung auszuüben , damit die Flüchtlinge in ihre Häuser 	zurückkehren 	könnten . 
zurueckkehren_s20538_f0	`` Ich kann nicht sehen , wie Nigeriakeywordtag weiter im Commonwealth verbleiben kann , ohne zu einer demokratischen Regierungsform 	zurückzukehren 	'' , meinte John Major , der sich tags zuvor noch gegen zuviel Druck auf das Regime gewandt hatte . 
zurueckkehren_s21059_f0	7. Alle Personen haben das Recht , unbehindert in ihre Wohnorte in der Region 	zurückzukehren 	und dort zu leben . 
zurueckkehren_s21699_f0	Einige Minuten später bin ichkeywordtag wieder zum Film 	zurückgekehrt 	. 
zurueckkehren_s23562_f0	Zunächst sollen dabei nach UNHCR-Vorstellungen die innerhalb Bosnien-Herzegowinas vor dem Krieg geflohenen 1,3 Millionen Menschen in ihre Heimatgebiete 	zurückkehren 	dürfen . 
zurueckkehren_s23564_f0	In der letzten Phasen sollen dann die Bosnier , die in Westeuropa Zuflucht gefunden haben , 	zurückkehren 	. 
zurueckkehren_s24669_f0	aber selbst wenn man nicht die lenkende Hand erfahrener Organisatoren gespürt hätte , wäre dies nichts im Vergleich zu den anderthalb Millionen gewesen , die spontan die Straßen säumten , als Husseinkeywordtag im Herbst 1992 von einer Krebsoperation in den USA nach Hause 	zurückkehrte 	. 
zurueckkehren_s26039_f0	Probleme bei der Unterbringung und Spannungen zwischen den Volksgruppen hätten dazu geführt , daß bisher nur wenige Menschen 	zurückgekehrt 	seien , teilten die UN in Sarajevo mit . 
zurueckkehren_s28380_f0	Christopher , der ursprünglich bis Anfang der kommenden Woche in Japan beim Asien-Pazifik-Gipfel bleiben sollte , will nach Angaben von US-Regierungsbeamten bereits am Freitag an den Ort der Verhandlungen 	zurückkehren 	und Druck für eine Einigung ausüben . 
zurueckkehren_s28723_f0	Die Straße war weiß , wenn das Flugzeug 	zurückkehrte 	. '' 
zurueckkehren_s30229_f0	Bevor die Sicherheitskräfte das Gefängnis stürmten , hatte sich das Gefängnispersonal geweigert , in die Justizvollzugsanstalt 	zurückzukehren 	. 
zurueckkehren_s30518_f0	Im Juli hatten Deutschland und Vietnam in einem sogenannten Reintegrationsabkommen beschlossen , daß die derzeit 40 000 in der Bundesrepublik lebenden Vietnamesen bis zum Jahr 2000 in ihr Heimatland 	zurückkehren 	müssen . 
zurueckkehren_s30782_f0	Viele Wählerinnen und Wähler erklärten , sie seien zur Urne gegangen , damit der Friede im Lande 	zurückkehre 	. 
zurueckkehren_s31392_f0	US-Außenminister Warren Christopher werde bereits am heutigen Freitag aus Japan nach Dayton 	zurückkehren 	, sagte sein Sprecher . 
zurueckkehren_s31507_f0	Nach Angaben aus der deutschen Delegation sind bisher nur wenige Vietnamesen 	zurückgekehrt 	. 
zurueckkehren_s31510_f0	Bis zum Jahr 2000 sollen nach dem Abkommen 40 000 Vietnamesen 	zurückkehren 	. 
zurueckkehren_s31977_f0	Wenn das Postschiff in den Heimathafen 	zurückkehrt 	, hat es zirka 2500 Seemeilen zurückgelegt . 
zurueckkehren_s32896_f0	Nach Moskau 	zurückgekehrt 	, arbeitete Bachtinkeywordtag am Institut für Weltliteratur an der russischen Akademie , hatte aber auch hier mit seiner Arbeit über Rabelais ( 1940 ) nur teilweise Erfolg . 
zurueckkehren_s33619_f0	Da er im Flugzeug einen Selbstmordversuch unternahm , durfte erkeywordtag vorerst 	zurückkehren 	. 
zurueckkehren_s34246_f0	Nach offiziellen Angaben sind bisher nur wenige Vietnamesen 	zurückgekehrt 	. 
